4
64 38

12 12 12 12 12 12 12 12 12 12 12 12 12 12 12 12 12 12 12 12 12 12 12 12 12 12 12 12 12 12 12 12 12 12 12 12 12 12 12 12 12 12 12 12 12 12 12 12 12 12 12 12 12 12 12 12 12 12 12 12 12 12 12 12 
12 10 10 10 10 10 10 10 10 10 10 12 10 10 10 12 10 10 10 10 12 12 12 12 12 12 12 12 10 10 10 12 12 12 12 12 12 12 12 12 12 12 12 12 12 12 12 12 12 12 12 12 12 12 12 12 12 12 12 12 12 10 10 12 
13 00 00 00 00 00 00 00 00 00 00 13 00 00 00 13 00 00 00 00 04 12 12 12 12 12 12 19 00 00 00 04 10 10 10 10 10 10 10 10 10 10 10 10 10 12 12 10 10 10 10 10 10 10 10 10 10 10 10 10 05 00 00 13 
13 00 00 00 00 00 06 14 14 08 00 17 00 07 00 17 00 07 00 00 00 04 12 12 12 10 12 12 08 00 00 00 00 00 00 00 00 00 00 00 00 00 00 00 00 04 05 00 00 00 00 00 00 00 00 00 00 00 00 00 00 00 00 13 
13 00 00 00 00 00 03 12 12 13 00 00 00 13 00 00 00 17 08 00 00 00 04 12 05 00 04 12 12 08 00 00 00 00 00 00 00 00 00 00 00 00 00 00 00 00 00 00 00 00 00 00 00 00 00 00 00 00 00 00 00 00 06 19 
13 00 00 00 00 00 03 12 12 12 14 14 14 12 14 14 18 00 00 08 00 00 00 17 00 00 00 04 12 12 08 00 00 00 16 14 14 14 08 00 00 06 14 08 00 00 00 00 06 14 08 00 00 06 14 14 14 18 00 00 00 06 12 19 
03 18 00 00 16 09 10 10 12 10 10 12 12 12 12 05 00 00 00 00 08 00 00 00 00 00 00 00 04 12 12 08 00 00 00 04 12 12 19 00 00 03 12 12 08 00 00 06 12 12 19 00 00 03 12 12 05 00 00 00 06 10 10 13 
13 00 00 00 00 00 00 00 13 00 00 03 12 12 05 00 00 00 00 00 00 18 00 00 00 06 00 00 00 04 12 12 08 00 00 00 04 12 19 00 00 04 10 10 05 00 00 04 10 10 05 00 00 03 12 05 00 00 00 06 19 00 00 13 
13 00 00 00 00 00 00 00 13 00 00 03 12 05 00 00 24 00 00 00 05 00 00 00 00 00 12 00 00 00 04 12 12 08 00 00 00 04 19 00 00 00 00 00 00 00 00 00 00 00 00 00 00 03 05 00 00 00 06 12 19 00 00 13 
13 00 00 00 00 00 00 00 17 00 00 03 05 00 00 00 00 00 00 05 00 00 00 07 00 00 00 05 00 00 00 04 12 12 08 00 00 00 04 00 00 00 00 00 00 00 00 00 00 00 00 00 00 05 00 00 00 06 12 12 19 00 00 13 
13 00 00 00 00 00 00 00 00 00 00 13 00 00 00 00 00 00 05 00 00 00 16 12 08 00 00 00 00 00 00 00 04 12 12 08 00 00 00 04 14 14 14 14 14 14 14 14 14 14 14 14 05 00 00 00 06 10 10 10 05 00 00 13 
13 00 00 00 00 22 00 00 00 00 00 13 00 00 00 06 00 05 00 00 00 00 00 04 12 18 00 00 00 06 00 00 00 04 12 12 08 00 00 00 04 12 12 12 12 12 12 12 12 12 12 05 00 00 00 06 19 00 00 00 00 00 00 13 
13 00 00 00 00 00 00 00 13 00 00 03 08 00 00 00 17 00 00 00 07 00 00 00 17 00 00 00 00 00 12 00 00 00 04 12 12 08 00 00 00 04 12 12 12 10 10 12 12 12 05 00 00 00 06 12 19 00 00 00 00 00 00 13 
13 00 00 00 00 00 00 00 13 00 00 03 12 08 00 00 00 00 00 06 12 08 00 00 00 00 00 07 00 00 00 05 00 00 00 04 12 12 08 00 00 00 04 12 05 00 00 04 12 05 00 00 00 16 12 12 19 00 00 00 07 00 00 13 
03 09 09 14 09 09 09 09 05 00 00 04 10 10 18 00 00 00 16 12 12 12 18 00 00 00 16 12 08 00 00 00 00 00 00 00 04 12 12 08 00 00 00 05 00 00 00 00 05 00 00 00 00 00 04 12 19 00 00 00 13 00 00 13 
13 00 00 13 00 00 00 00 00 00 00 00 00 00 00 05 00 00 00 04 12 05 00 00 00 00 00 04 12 18 00 00 00 06 00 00 00 04 12 12 08 00 00 00 00 00 00 00 00 00 00 07 00 00 00 04 19 00 00 00 13 00 00 13 
13 00 00 13 00 00 00 00 00 00 00 00 00 00 00 00 07 00 00 00 17 00 00 00 07 00 00 00 17 00 00 00 00 00 12 00 00 00 04 12 12 05 00 00 00 16 18 00 00 00 16 12 08 00 00 00 17 00 00 00 13 00 00 13 
13 00 00 17 00 00 00 00 00 00 00 00 00 00 00 00 03 08 00 00 00 00 00 06 12 08 00 00 00 00 00 07 00 00 00 05 00 00 00 03 05 00 00 00 00 00 00 00 00 00 00 04 12 08 00 00 00 16 09 09 05 00 00 13 
13 00 00 00 00 00 00 00 00 00 00 00 00 00 00 00 03 12 08 00 00 00 16 12 12 12 18 00 00 00 16 12 08 00 00 00 00 00 06 19 00 00 00 07 00 00 00 00 07 00 00 00 03 12 08 00 00 00 00 00 00 00 00 13 
13 00 00 00 00 00 00 00 00 00 00 00 00 00 00 00 03 10 10 08 00 00 00 04 12 05 00 00 00 00 00 04 12 18 00 00 00 16 12 19 00 00 00 17 00 00 00 00 17 00 00 00 03 12 05 00 00 00 00 00 00 00 00 13 
13 00 00 07 00 00 00 00 00 00 00 00 00 00 00 00 13 00 00 03 08 00 00 00 17 00 00 00 07 00 00 00 17 00 00 00 00 00 04 12 08 00 00 00 00 00 00 00 00 00 00 06 12 05 00 00 00 16 09 09 08 00 00 13 
13 00 00 13 00 00 00 00 00 00 00 00 00 00 00 00 13 00 00 03 12 08 00 00 00 00 00 06 12 08 00 00 00 00 00 07 00 00 00 04 12 18 00 00 00 16 18 00 00 00 04 12 05 00 00 00 07 00 00 00 13 00 00 13 
13 00 00 13 00 00 00 00 00 00 00 00 00 00 00 00 13 00 00 04 10 10 18 00 00 00 16 12 12 12 18 00 00 00 04 12 08 00 00 00 17 00 00 00 00 00 00 00 00 00 00 04 00 00 00 06 19 00 00 00 13 00 00 13 
13 00 00 13 00 00 00 00 00 00 00 00 00 00 00 00 13 00 00 00 00 00 00 07 00 00 00 04 12 05 00 00 00 00 00 04 12 18 00 00 00 00 00 07 00 00 00 00 07 00 00 00 00 00 06 12 19 00 00 00 13 00 00 13 
13 00 00 13 00 00 00 00 00 00 00 00 00 00 00 00 13 00 00 00 00 00 00 03 08 00 00 00 17 00 00 00 07 00 00 00 17 00 00 00 00 00 16 12 08 00 00 06 12 18 00 00 00 04 12 12 19 00 00 00 17 00 00 13 
13 00 00 17 00 00 00 00 00 00 00 00 00 00 00 00 13 00 00 06 09 09 09 10 10 18 00 00 00 00 00 06 12 08 00 00 00 00 00 00 00 00 00 04 12 14 14 12 05 00 00 00 00 00 04 12 19 00 00 00 00 00 00 13 
13 00 00 00 00 00 00 00 00 00 00 00 00 00 00 00 13 00 00 17 00 00 00 00 00 00 07 00 00 00 16 12 12 12 08 00 00 00 00 00 07 00 00 00 04 12 12 05 00 00 00 07 00 00 00 04 19 00 00 00 00 00 00 13 
13 00 00 00 00 00 00 00 00 00 00 00 00 00 00 00 13 00 00 00 00 00 00 00 16 09 12 08 00 00 00 04 12 12 12 05 00 00 00 06 12 08 00 00 00 04 05 00 00 00 06 12 08 00 00 00 04 14 14 14 08 00 00 13 
13 00 00 07 00 00 00 00 00 00 00 00 00 00 00 00 13 00 00 00 00 00 00 00 00 00 03 12 08 00 00 00 03 12 05 00 00 00 06 12 12 12 08 00 00 00 00 00 00 06 12 12 12 08 00 00 00 04 12 12 13 00 00 13 
13 00 00 13 00 00 00 00 00 00 00 00 00 00 00 00 13 00 00 07 00 00 00 00 16 09 12 12 12 08 00 06 12 05 00 00 00 06 12 12 12 12 12 08 00 00 00 00 06 12 12 12 12 12 08 00 00 00 04 12 13 00 00 13 
13 00 00 13 00 00 00 00 00 00 00 00 00 00 00 00 17 00 00 13 00 00 00 00 00 00 03 12 12 12 14 12 05 00 00 00 06 12 12 10 10 10 10 10 18 00 00 16 10 10 10 10 10 12 12 08 00 00 00 04 13 00 00 13 
13 00 00 13 00 00 00 00 00 00 00 00 00 00 00 00 00 00 00 13 00 00 00 00 16 09 10 10 10 10 10 05 00 00 00 06 12 12 12 00 00 00 00 00 00 00 00 00 00 00 00 00 00 12 12 12 08 00 00 00 04 13 13 13 
13 00 00 04 09 09 09 08 00 00 00 00 00 00 00 00 00 00 00 13 00 00 00 00 00 00 00 00 00 00 00 00 00 00 06 12 12 12 12 00 00 00 00 00 00 00 00 00 00 00 00 00 00 12 12 12 12 08 00 00 00 04 13 13 
13 00 00 00 00 00 00 13 00 00 24 00 00 00 22 00 07 00 00 13 00 00 00 06 09 09 14 14 14 18 00 00 00 06 12 12 12 12 12 00 00 00 00 00 00 00 00 00 00 00 00 00 00 12 12 12 12 12 08 00 00 00 04 13 
13 00 00 00 00 00 00 13 00 00 00 00 00 00 00 00 13 00 00 13 00 00 00 17 00 00 03 12 05 00 00 00 06 12 12 12 12 12 12 00 00 00 00 00 00 00 00 00 00 00 00 00 00 12 12 12 12 12 12 08 00 00 00 13 
13 00 00 00 00 00 00 13 00 00 00 00 00 00 00 00 13 00 00 13 00 00 00 00 00 00 13 19 00 00 00 06 12 12 12 12 12 12 12 00 00 00 00 00 00 00 00 00 00 00 00 00 00 12 12 12 12 12 12 12 08 00 00 13 
04 09 09 09 09 09 09 10 09 09 09 09 09 09 09 09 10 09 09 09 09 09 09 09 09 09 10 10 09 09 09 10 10 10 10 10 10 10 10 09 09 09 09 09 09 09 09 09 09 09 09 09 09 10 10 10 10 10 10 10 10 09 09 05 
20 20 20 20 20 20 20 20 20 20 20 20 20 20 20 20 20 20 20 20 20 20 20 20 20 20 20 20 20 20 20 20 20 20 20 20 20 20 20 20 20 20 20 20 20 20 20 20 20 20 20 20 20 20 20 20 20 20 20 20 20 20 20 20 

8
stairs 05 11 10 07 3 r
stairs 14 33 60 08 3 r
stairs 16 08 09 03 5 r
stairs 10 33 58 34 5 r

objective 46 13 25 45 0 assets/Graphics/objects/png_object/object_animation.txt
objective 62 20 25 45 1 assets/Graphics/objects/png_object/object_animation.txt
objective 06 22 25 45 2 assets/Graphics/objects/png_object/object_animation.txt
objective 52 31 25 45 3 assets/Graphics/objects/png_object/object_animation.txt
