1
64 38

06 09 09 09 09 14 09 09 09 09 09 09 09 09 09 09 14 09 09 09 09 09 09 09 09 09 09 09 09 09 09 14 09 09 09 09 09 09 09 09 09 09 09 09 09 09 09 14 09 09 09 14 09 09 09 09 14 09 09 09 09 09 09 08 
13 20 20 20 20 13 20 20 20 20 20 20 20 20 20 20 13 20 20 20 20 20 20 20 20 20 20 20 20 20 20 13 20 20 20 20 20 20 20 20 20 20 20 20 20 20 20 13 20 20 20 17 20 20 20 20 13 20 20 20 20 20 20 13 
13 00 22 23 00 13 00 00 00 00 00 00 00 00 00 00 13 00 00 00 00 00 00 00 00 00 00 00 00 00 00 13 00 00 00 00 00 00 00 00 00 00 00 00 00 00 00 13 00 00 00 20 00 00 00 00 13 00 00 00 00 00 00 13 
13 00 00 00 00 13 00 00 00 00 00 00 00 00 00 00 13 00 00 00 00 00 00 00 00 00 00 00 00 00 00 13 00 00 00 07 00 00 00 00 00 00 00 00 00 00 00 13 00 00 00 00 00 00 00 00 17 00 00 00 00 00 00 13 
13 00 00 00 00 13 00 00 00 00 00 00 00 00 00 00 13 00 00 00 00 00 00 00 00 00 00 00 00 00 00 13 00 00 00 13 00 00 00 00 00 00 00 00 00 00 00 13 00 00 00 07 00 00 00 00 20 00 00 00 00 00 00 13 
03 18 00 00 16 19 00 00 00 00 00 00 00 00 00 00 13 00 00 00 00 00 00 00 00 00 00 00 00 00 00 13 00 00 00 13 00 00 00 00 00 00 00 00 00 00 00 13 00 00 00 13 00 00 00 00 00 00 00 00 00 00 00 13 
13 20 00 00 20 13 00 00 00 00 00 00 00 00 00 00 13 00 00 00 00 00 00 00 00 00 00 00 00 00 00 13 00 00 00 13 00 00 00 00 00 00 00 00 00 00 00 13 00 00 00 13 00 00 00 00 07 00 00 00 00 00 00 13 
13 00 00 00 00 13 00 00 00 00 00 00 00 00 00 00 13 00 00 00 00 00 00 00 00 00 00 00 00 00 00 13 00 00 00 13 00 00 00 00 00 00 00 00 00 00 00 13 00 00 00 13 00 00 00 00 13 00 00 00 00 00 00 13 
13 00 00 00 00 13 00 00 00 00 00 00 00 00 00 00 13 00 00 00 00 00 00 00 00 00 00 00 00 00 00 13 00 00 00 13 00 00 00 00 00 00 00 00 00 00 00 13 00 00 00 13 00 00 00 00 13 00 00 00 00 00 00 13 
13 00 00 00 00 13 00 00 00 00 00 00 00 00 00 00 13 00 00 00 00 00 00 00 00 00 00 00 00 00 00 13 00 00 00 13 00 00 00 00 00 00 00 00 00 00 00 13 00 00 00 13 00 00 00 00 04 18 00 00 16 09 09 19 
13 00 00 00 00 04 09 09 09 09 09 09 09 18 00 00 17 00 00 16 09 09 09 09 09 09 09 09 09 09 09 05 00 00 00 13 00 00 00 00 00 00 00 00 00 00 00 17 00 00 00 13 00 00 00 00 20 20 00 00 20 20 20 13 
13 00 00 00 00 20 20 37 20 20 20 20 20 20 00 00 20 00 00 20 20 20 20 20 20 20 20 20 20 20 20 20 00 00 00 13 00 00 00 00 00 00 00 00 00 00 00 20 00 00 00 13 00 00 00 00 00 00 00 00 00 00 00 13 
13 00 00 00 00 00 00 36 00 00 00 00 00 00 00 00 00 00 00 00 00 00 00 00 00 00 00 00 00 00 00 00 00 00 00 13 00 00 00 00 00 00 00 00 00 00 00 00 00 00 00 13 00 00 00 00 00 00 00 00 00 00 00 13 
13 00 00 00 00 00 00 00 00 00 00 00 00 00 00 00 00 00 00 00 00 00 00 00 00 00 00 00 00 00 00 00 00 00 00 03 09 09 09 09 09 09 09 09 09 09 09 09 09 09 09 19 00 00 00 00 00 00 00 00 00 00 00 13 
13 00 00 00 00 00 00 00 00 00 00 00 00 00 00 00 00 00 00 00 00 00 00 00 00 00 00 00 00 00 00 07 00 00 00 13 20 20 20 20 20 20 20 20 20 20 20 20 20 20 20 13 00 00 00 00 00 00 00 00 00 00 00 13 
13 00 00 00 00 00 00 00 00 00 00 00 00 00 00 00 00 00 00 00 00 00 00 00 00 00 00 00 00 00 00 13 00 00 00 13 00 00 00 00 00 00 00 00 00 00 00 00 00 00 00 17 00 00 00 00 00 00 00 00 00 00 00 13 
13 00 00 00 00 00 00 00 00 00 00 00 00 00 00 00 00 00 00 00 00 00 00 00 00 00 00 00 00 00 00 03 09 09 09 05 00 00 00 00 00 00 00 00 00 00 00 00 00 00 00 20 00 00 00 00 00 00 00 00 00 00 00 13 
13 00 00 00 00 00 00 00 00 00 00 00 00 00 00 00 00 00 00 00 00 00 00 00 00 00 00 00 00 00 00 13 20 20 20 20 00 00 00 00 00 00 00 00 00 00 00 00 00 00 00 00 00 00 00 00 00 00 00 00 00 00 00 13 
13 00 00 00 00 00 00 00 00 00 00 00 00 00 00 00 00 00 00 00 00 00 00 00 00 00 00 00 00 00 00 13 00 00 00 00 00 00 00 00 00 00 00 00 00 00 00 00 00 00 00 07 00 00 00 00 00 00 00 00 00 00 00 13 
13 00 00 00 00 00 00 00 00 00 00 00 00 00 00 00 00 00 00 00 00 00 00 00 00 00 00 00 00 00 00 17 00 00 00 00 00 00 00 00 00 00 00 00 00 00 00 00 00 00 00 13 00 00 00 00 00 00 00 00 00 00 00 13 
13 00 00 00 00 00 00 00 00 00 00 00 00 00 00 00 00 00 00 00 00 00 00 00 00 00 00 00 00 00 00 20 00 00 00 00 00 00 00 00 00 00 00 00 00 00 00 00 00 00 00 13 00 00 00 00 00 00 00 00 00 00 00 13 
13 00 00 00 00 00 00 00 00 00 00 00 00 00 00 00 00 00 00 00 00 00 00 00 00 00 00 00 00 00 00 00 00 00 00 00 00 00 00 00 00 00 00 00 00 00 00 00 00 00 00 13 00 00 00 06 09 09 18 00 00 16 09 19 
13 00 00 00 00 00 00 00 00 00 00 00 00 00 00 00 00 00 00 00 00 00 00 00 00 00 00 00 00 00 00 07 00 00 16 09 14 09 18 00 00 16 14 09 09 18 00 00 16 09 09 19 00 00 00 13 20 20 20 00 00 20 20 13 
03 09 08 00 00 00 00 00 00 00 00 00 00 00 00 00 00 00 00 00 00 00 00 00 00 00 00 00 00 00 00 13 00 00 20 20 13 00 00 00 00 20 13 20 20 20 00 00 20 20 20 13 00 00 00 13 00 00 00 00 00 00 00 13 
13 20 13 00 00 00 00 00 00 00 00 00 00 00 00 00 00 00 00 00 00 00 00 00 00 00 00 00 00 00 00 13 00 00 00 00 13 00 00 00 00 00 13 00 00 00 00 00 00 00 00 13 00 00 00 13 00 00 00 00 00 00 00 13 
13 00 13 00 00 00 00 00 00 00 00 00 00 00 00 00 00 00 00 00 00 00 06 09 09 09 18 00 00 16 09 19 00 00 00 00 13 00 00 00 00 00 13 00 00 00 00 00 00 00 00 13 00 00 00 13 00 00 00 00 00 00 00 13 
13 00 13 00 00 00 00 00 00 00 00 00 00 00 00 00 00 00 00 00 00 00 13 20 20 20 20 00 00 20 20 13 00 00 16 09 10 09 09 09 09 09 12 09 09 09 09 09 18 00 00 13 00 00 00 13 00 00 00 00 00 00 00 13 
13 00 13 00 00 00 00 00 00 00 00 00 00 00 00 00 00 00 00 00 00 00 13 00 00 00 00 00 00 00 00 13 00 00 20 20 20 20 20 20 20 20 13 20 20 20 20 20 20 00 00 13 00 00 00 13 00 00 00 00 00 00 00 13 
13 00 17 00 00 00 00 00 00 00 00 00 00 00 00 00 00 00 00 00 00 00 13 00 00 00 00 00 00 00 00 13 00 00 00 00 00 00 00 00 00 00 13 00 00 00 00 00 00 00 00 13 00 00 00 13 00 00 00 00 00 00 00 13 
13 00 20 00 00 00 00 00 00 00 00 00 00 00 00 00 00 00 00 00 00 00 13 00 00 00 00 00 00 00 00 13 00 00 00 00 00 00 00 00 00 00 13 00 00 00 00 00 00 00 00 13 00 00 00 13 00 00 00 00 00 00 00 13 
13 00 00 00 00 00 00 00 00 00 00 00 00 00 00 00 00 00 00 00 00 00 13 00 00 00 00 00 00 00 00 13 00 00 00 00 00 00 00 00 00 00 03 09 09 18 00 00 00 00 00 13 00 00 00 13 00 00 00 00 00 00 00 13 
13 00 07 00 00 00 00 00 00 00 00 00 00 00 00 00 00 00 00 00 00 00 13 00 00 00 00 00 00 00 00 13 00 00 00 00 00 00 00 00 00 00 13 20 20 20 00 00 00 00 00 13 00 00 00 13 00 00 00 00 00 00 00 13 
13 00 13 00 00 00 00 00 00 00 00 00 00 00 00 00 00 00 00 00 00 00 13 00 00 00 00 00 00 00 00 13 00 00 00 00 00 00 00 00 00 00 13 00 00 00 00 00 00 00 00 13 00 00 00 13 00 00 00 00 00 00 00 13 
13 00 13 00 00 00 00 00 00 06 18 00 00 16 09 09 09 09 09 09 09 09 10 09 09 18 00 00 16 09 09 10 09 09 09 09 09 14 18 00 00 16 10 09 09 09 09 09 09 09 09 05 00 00 16 10 09 09 09 09 09 09 09 19 
13 00 13 00 00 00 00 00 00 13 20 00 00 20 20 20 20 20 20 20 20 20 20 20 20 20 00 00 20 20 20 20 20 20 20 20 20 13 20 00 00 20 20 20 20 20 20 20 20 20 20 20 00 00 20 20 20 20 20 20 20 20 20 13 
13 00 13 00 00 00 00 00 00 13 00 00 00 00 00 00 00 00 00 00 00 00 00 00 00 00 00 00 00 00 00 00 00 00 00 00 00 13 23 00 00 00 00 00 00 00 00 00 00 00 00 00 00 00 00 00 00 00 00 00 00 00 00 13 
04 09 10 09 09 09 09 09 09 10 09 09 09 09 09 09 09 09 09 09 09 09 09 09 09 09 09 09 09 09 09 09 09 09 09 09 09 10 09 09 09 09 09 09 09 09 09 09 09 09 09 09 09 09 09 09 09 09 09 09 09 09 09 05 
20 20 20 25 20 20 25 20 20 25 20 20 25 20 20 25 20 20 25 20 20 25 20 20 25 20 20 25 20 20 25 20 20 25 20 20 25 20 20 25 20 20 25 20 20 25 20 20 25 20 20 25 20 20 25 20 20 25 20 20 25 20 20 20 

2
stair 02 02 3.5 05 0
stair 03 02 1.5 02 2
