0
64 38

06 09 09 09 09 14 09 09 09 09 09 09 09 09 09 09 14 09 09 09 09 09 09 09 09 09 09 09 09 09 09 14 09 09 09 09 09 09 09 09 09 09 09 09 09 09 09 14 09 09 09 14 09 09 09 09 14 09 09 09 09 09 09 08 
13 20 20 20 20 13 20 20 20 20 20 20 20 20 20 20 13 20 20 20 20 20 20 20 20 20 20 20 20 20 20 13 20 20 20 20 20 20 20 20 20 20 20 20 20 20 20 13 20 20 20 13 20 20 20 20 13 20 20 20 20 20 20 13 
13 00 00 00 24 13 00 00 00 00 00 00 00 00 00 00 13 00 00 00 00 00 00 00 00 00 00 00 00 00 00 13 00 00 00 00 00 00 00 00 00 00 00 00 00 00 00 13 00 00 00 20 00 00 00 00 13 00 00 00 00 00 00 13 
13 00 00 00 00 13 00 00 00 00 00 00 00 00 00 00 13 00 00 00 00 00 00 00 00 00 00 00 00 00 00 13 00 00 00 07 00 00 00 00 00 00 00 00 00 00 00 13 00 00 00 00 00 00 00 00 17 00 00 00 00 00 00 13 
13 00 00 00 00 13 00 40 00 00 00 00 00 00 00 00 13 00 00 00 00 00 00 00 00 00 00 00 00 00 00 13 00 00 00 13 00 00 00 00 00 00 00 00 00 00 00 13 00 00 00 07 00 00 00 00 20 00 00 26 27 00 00 13 
03 18 00 00 16 19 00 38 00 00 00 00 00 00 00 00 13 00 00 00 00 00 00 00 00 00 00 00 00 00 00 13 00 00 00 13 00 00 00 00 00 00 00 00 00 00 00 13 00 00 00 13 00 00 00 00 00 00 00 28 29 00 00 13 
13 20 00 00 20 13 00 38 38 38 38 38 00 00 00 00 13 00 00 00 00 00 00 00 00 00 00 00 00 00 00 13 00 00 00 13 00 00 00 00 00 00 00 00 00 00 00 13 00 00 00 13 00 00 00 00 07 00 00 00 00 00 00 13 
13 00 00 00 00 13 00 39 00 00 00 39 00 00 00 00 13 00 00 00 00 00 00 00 00 00 00 00 00 00 00 13 00 00 00 13 00 00 00 00 00 00 00 00 00 00 00 13 00 00 00 13 00 00 00 00 13 00 00 00 00 00 00 13 
13 00 00 00 00 13 00 00 00 00 00 00 00 00 00 00 13 00 00 00 00 00 00 00 00 00 00 00 00 00 00 13 00 00 00 13 00 00 00 00 00 00 00 00 00 00 00 13 00 00 00 13 00 00 00 00 13 00 00 00 00 00 00 13 
13 00 00 00 00 13 00 00 00 00 00 00 00 00 00 00 13 00 00 00 00 00 00 00 00 00 00 00 00 00 00 13 00 00 00 13 00 00 00 00 00 00 00 00 00 00 00 13 00 00 00 13 00 00 00 00 04 18 00 00 16 09 09 19 
13 00 00 00 00 04 09 09 09 09 09 09 09 18 00 00 17 00 00 16 09 09 09 09 09 09 09 09 09 09 09 05 00 00 00 13 00 00 00 00 00 00 00 00 00 00 00 17 00 00 00 13 00 00 00 00 20 20 00 00 20 20 20 13 
13 00 00 00 00 20 20 37 20 20 20 20 20 20 00 00 20 00 00 20 20 20 20 20 20 20 20 20 20 20 20 20 00 00 00 13 00 00 00 00 00 00 00 00 00 00 00 20 00 00 00 13 00 00 00 00 00 00 00 00 00 00 00 13 
13 00 00 00 00 00 00 36 00 00 00 00 00 00 00 00 00 00 00 00 00 00 00 00 00 00 00 00 00 00 00 00 00 00 00 13 00 00 00 00 00 00 00 00 00 00 00 00 00 00 00 13 00 00 00 00 00 00 00 00 00 00 00 13 
13 00 00 00 00 00 00 00 00 00 00 00 00 00 00 00 00 00 00 00 00 00 00 00 00 00 00 00 00 00 00 00 00 00 00 03 09 09 09 09 09 09 09 09 09 09 09 09 09 09 09 19 00 00 00 00 00 00 00 00 00 00 00 13 
13 00 00 00 00 00 00 00 00 00 00 00 00 00 00 00 00 00 00 00 00 00 00 00 00 00 00 00 00 00 00 07 00 00 00 13 20 20 20 20 20 20 20 20 20 20 20 20 20 20 20 13 00 00 00 00 00 00 00 00 00 00 00 13 
13 00 00 00 00 00 40 00 00 00 00 00 00 00 00 00 00 00 00 00 00 00 00 00 00 00 00 00 00 00 00 13 00 00 00 13 00 00 00 00 00 00 00 00 00 00 00 00 00 00 00 17 00 00 00 00 00 00 00 00 00 00 00 13 
13 00 00 00 00 00 38 00 00 00 00 00 00 00 00 00 00 00 00 00 00 00 00 00 00 00 00 00 00 00 00 03 09 09 09 05 00 00 00 00 00 00 00 00 00 00 00 00 00 00 00 20 00 00 00 00 00 00 00 00 00 00 00 13 
13 00 00 00 00 00 38 00 00 00 00 00 00 00 00 00 00 00 00 00 00 00 00 00 00 00 00 00 00 00 00 13 20 20 20 20 00 00 00 00 00 00 00 00 00 00 00 00 00 00 00 00 00 00 00 00 00 00 00 00 00 00 00 13 
13 00 00 00 00 00 38 00 00 00 00 00 00 00 00 00 00 00 00 00 00 00 00 00 00 00 00 00 00 00 00 13 00 00 00 00 00 00 00 00 00 00 00 00 00 00 00 00 00 00 00 07 00 00 00 00 00 00 00 00 00 00 00 13 
13 00 00 00 00 00 38 38 38 38 38 00 00 00 00 00 00 00 00 00 00 00 00 00 00 00 00 00 00 00 00 17 00 00 00 00 00 00 00 00 00 00 00 00 00 00 00 00 00 00 00 13 00 00 00 00 00 00 00 00 00 00 00 13 
13 00 00 00 00 00 00 00 00 00 00 00 00 00 00 00 00 00 00 00 00 00 00 00 00 00 00 00 00 00 00 20 00 00 00 00 00 00 00 00 00 00 00 00 00 00 00 00 00 00 00 13 00 00 00 00 00 00 00 00 00 00 00 13 
13 00 00 00 00 00 38 38 38 38 38 00 00 00 00 00 00 00 00 00 00 00 00 00 00 00 00 00 00 00 00 00 00 00 00 00 00 00 00 00 00 00 00 00 00 00 00 00 00 00 00 13 00 00 00 06 09 09 18 00 00 16 09 19 
13 00 00 00 00 00 38 00 00 00 00 00 00 00 00 00 00 00 00 00 00 00 00 00 00 00 00 00 00 00 00 07 00 00 16 09 14 09 18 00 00 16 14 09 09 18 00 00 16 09 09 19 00 00 00 13 20 20 20 00 00 20 20 13 
03 09 08 00 00 00 38 00 00 00 00 00 00 00 00 00 00 00 00 00 00 00 00 00 00 00 00 00 00 00 00 13 00 00 20 20 13 30 31 00 00 20 13 20 20 20 00 00 20 20 20 13 00 00 00 13 00 00 00 00 00 00 00 13 
13 20 13 00 00 00 39 00 00 00 00 00 00 00 00 00 00 00 00 00 00 00 00 00 00 00 00 00 00 00 00 13 00 00 00 00 13 32 33 00 00 00 13 00 00 00 00 00 00 00 00 13 00 00 00 13 00 00 00 00 00 00 00 13 
13 00 13 00 00 00 00 00 00 00 00 00 00 00 00 00 00 00 00 00 00 00 06 09 09 09 18 00 00 16 09 19 00 00 00 00 13 34 35 00 00 00 13 00 00 00 00 00 00 00 00 13 00 00 00 13 00 00 00 00 00 00 00 13 
13 00 13 00 00 00 00 00 00 00 00 00 00 00 00 00 00 00 00 00 00 00 13 20 20 20 20 00 00 20 20 13 00 00 16 09 10 09 09 09 09 09 12 09 09 09 09 09 18 00 00 13 00 00 00 13 00 00 00 00 00 00 00 13 
13 00 13 00 00 00 00 00 00 00 00 00 00 00 00 00 00 00 00 00 00 00 13 00 00 00 00 00 00 00 00 13 00 00 20 20 20 20 20 20 20 20 13 20 20 20 20 20 20 00 00 13 00 00 00 13 00 00 00 00 00 00 00 13 
13 00 17 00 00 00 00 00 00 00 00 00 00 00 00 00 00 00 00 00 00 00 13 00 00 00 00 00 00 00 00 13 00 00 00 00 00 00 00 00 00 00 13 00 00 00 00 00 00 00 00 13 00 00 00 13 00 00 00 00 00 00 00 13 
13 00 20 00 00 00 00 00 00 00 00 00 00 00 00 00 00 00 00 00 00 00 13 00 00 00 00 00 00 00 00 13 00 00 00 00 00 00 00 00 00 00 13 00 00 00 00 00 00 00 00 13 00 00 00 13 00 00 00 00 00 00 00 13 
13 00 00 00 00 00 00 00 00 00 00 00 00 00 00 00 00 00 00 00 00 00 13 00 00 00 00 00 00 00 00 13 00 00 00 00 00 00 00 00 00 00 03 09 09 18 00 00 00 00 00 13 00 00 00 13 00 00 00 00 00 00 00 13 
13 00 07 00 00 00 00 00 00 00 00 00 00 00 00 00 00 00 00 00 00 00 13 00 00 00 00 00 00 00 00 13 00 00 00 00 00 00 00 00 00 00 13 20 20 20 00 00 00 00 00 13 00 00 00 13 00 00 00 00 00 00 00 13 
13 00 13 00 00 00 00 00 00 00 00 00 00 00 00 00 00 00 00 00 00 00 13 00 00 00 00 00 00 00 00 13 00 00 00 00 00 00 00 00 00 00 13 00 00 00 00 00 00 00 00 13 00 00 00 13 00 00 00 00 00 00 00 13 
13 00 13 00 00 00 00 00 00 06 18 00 00 16 09 09 09 09 09 09 09 09 10 09 09 18 00 00 16 09 09 10 09 09 09 09 09 14 18 00 00 16 10 09 09 09 09 09 09 09 09 05 00 00 16 10 09 09 09 09 09 09 09 19 
13 00 13 00 00 00 00 00 00 13 20 00 00 20 20 20 20 20 20 20 20 20 20 20 20 20 00 00 20 20 20 20 20 20 20 20 20 13 20 00 00 20 20 20 20 20 20 20 20 20 20 20 00 00 20 20 20 20 20 20 20 20 20 13 
13 00 13 00 00 00 00 00 00 13 00 00 00 00 00 00 00 00 00 00 00 00 00 00 00 00 00 00 00 00 00 00 00 00 00 00 00 13 23 00 00 00 00 00 00 00 00 00 00 00 00 00 00 00 00 00 00 00 00 00 00 00 00 13 
04 09 10 09 09 09 09 09 09 10 09 09 09 09 09 09 09 09 09 09 09 09 09 09 09 09 09 09 09 09 09 09 09 09 09 09 09 10 09 09 09 09 09 09 09 09 09 09 09 09 09 09 09 09 09 09 09 09 09 09 09 09 09 05
20 20 20 25 20 20 25 20 20 25 20 20 25 20 20 25 20 20 25 20 20 25 20 20 25 20 20 25 20 20 25 20 20 25 20 20 25 20 20 25 20 20 25 20 20 25 20 20 25 20 20 25 20 20 25 20 20 25 20 20 25 20 20 20

stairs 04 02 02 17 2
stairs 35 38 61 08 2
