0
64 38

06 09 09 09 09 14 09 09 09 09 09 09 09 09 09 09 14 09 09 09 09 09 09 09 09 09 09 09 09 09 09 14 09 09 09 09 09 09 09 09 09 09 09 09 09 09 09 14 09 09 09 14 09 09 09 09 14 09 09 09 09 09 09 08 
13 01 01 01 01 13 01 01 01 01 01 01 01 01 01 01 13 01 01 01 01 01 01 01 01 01 01 01 01 01 01 13 01 01 01 01 01 01 01 01 01 01 01 01 01 01 01 13 01 01 01 13 01 01 01 01 13 01 01 01 01 01 01 13 
13 01 01 01 01 13 01 01 01 01 01 01 01 01 01 01 13 01 01 01 01 01 01 01 01 01 01 01 01 01 01 13 01 01 01 01 01 01 01 01 01 01 01 01 01 01 01 13 01 01 01 17 01 01 01 01 13 01 01 01 01 01 01 13 
13 01 01 01 01 13 01 01 01 01 01 01 01 01 01 01 13 01 01 01 01 01 01 01 01 01 01 01 01 01 01 13 01 01 01 01 01 01 01 01 01 01 01 01 01 01 01 13 01 01 01 01 01 01 01 01 13 01 01 01 01 01 01 13 
13 01 01 01 01 13 01 01 01 01 01 01 01 01 01 01 13 01 01 01 01 01 01 01 01 01 01 01 01 01 01 13 01 01 01 07 01 01 01 01 01 01 01 01 01 01 01 13 01 01 01 01 01 01 01 01 17 01 01 01 01 01 01 13 
13 01 01 01 01 13 01 01 01 01 01 01 01 01 01 01 13 01 01 01 01 01 01 01 01 01 01 01 01 01 01 13 01 01 01 13 01 01 01 01 01 01 01 01 01 01 01 13 01 01 01 07 01 01 01 01 01 01 01 01 01 01 01 13 
03 18 01 01 16 19 01 01 01 01 01 01 01 01 01 01 13 01 01 01 01 01 01 01 01 01 01 01 01 01 01 13 01 01 01 13 01 01 01 01 01 01 01 01 01 01 01 13 01 01 01 13 01 01 01 01 01 01 01 01 01 01 01 13 
13 01 01 01 01 13 01 01 01 01 01 01 01 01 01 01 13 01 01 01 01 01 01 01 01 01 01 01 01 01 01 13 01 01 01 13 01 01 01 01 01 01 01 01 01 01 01 13 01 01 01 13 01 01 01 01 07 01 01 01 01 01 01 13 
13 01 01 01 01 13 01 01 01 01 01 01 01 01 01 01 13 01 01 01 01 01 01 01 01 01 01 01 01 01 01 13 01 01 01 13 01 01 01 01 01 01 01 01 01 01 01 13 01 01 01 13 01 01 01 01 13 01 01 01 01 01 01 13 
13 01 01 01 01 13 01 01 01 01 01 01 01 01 01 01 13 01 01 01 01 01 01 01 01 01 01 01 01 01 01 13 01 01 01 13 01 01 01 01 01 01 01 01 01 01 01 13 01 01 01 13 01 01 01 01 13 01 01 01 01 01 01 13 
13 01 01 01 01 13 01 01 01 01 01 01 01 01 01 01 13 01 01 01 01 01 01 01 01 01 01 01 01 01 01 13 01 01 01 13 01 01 01 01 01 01 01 01 01 01 01 13 01 01 01 13 01 01 01 01 04 18 01 01 16 09 09 19 
13 01 01 01 01 04 09 09 09 09 09 09 09 18 01 01 17 01 01 16 09 09 09 09 09 09 09 09 09 09 09 05 01 01 01 13 01 01 01 01 01 01 01 01 01 01 01 17 01 01 01 13 01 01 01 01 01 01 01 01 01 01 01 13 
13 01 01 01 01 01 01 01 01 01 01 01 01 01 01 01 01 01 01 01 01 01 01 01 01 01 01 01 01 01 01 01 01 01 01 13 01 01 01 01 01 01 01 01 01 01 01 01 01 01 01 13 01 01 01 01 01 01 01 01 01 01 01 13 
13 01 01 01 01 01 01 01 01 01 01 01 01 01 01 01 01 01 01 01 01 01 01 01 01 01 01 01 01 01 01 01 01 01 01 13 01 01 01 01 01 01 01 01 01 01 01 01 01 01 01 13 01 01 01 01 01 01 01 01 01 01 01 13 
13 01 01 01 01 01 01 01 01 01 01 01 01 01 01 01 01 01 01 01 01 01 01 01 01 01 01 01 01 01 01 01 01 01 01 03 09 09 09 09 09 09 09 09 09 09 09 09 09 09 09 19 01 01 01 01 01 01 01 01 01 01 01 13 
13 01 01 01 01 01 01 01 01 01 01 01 01 01 01 01 01 01 01 01 01 01 01 01 01 01 01 01 01 01 01 07 01 01 01 13 01 01 01 01 01 01 01 01 01 01 01 01 01 01 01 13 01 01 01 01 01 01 01 01 01 01 01 13 
13 01 01 01 01 01 01 01 01 01 01 01 01 01 01 01 01 01 01 01 01 01 01 01 01 01 01 01 01 01 01 13 01 01 01 13 01 01 01 01 01 01 01 01 01 01 01 01 01 01 01 17 01 01 01 01 01 01 01 01 01 01 01 13 
13 01 01 01 01 01 01 01 01 01 01 01 01 01 01 01 01 01 01 01 01 01 01 01 01 01 01 01 01 01 01 03 09 09 09 05 01 01 01 01 01 01 01 01 01 01 01 01 01 01 01 01 01 01 01 01 01 01 01 01 01 01 01 13 
13 01 01 01 01 01 01 01 01 01 01 01 01 01 01 01 01 01 01 01 01 01 01 01 01 01 01 01 01 01 01 13 01 01 01 01 01 01 01 01 01 01 01 01 01 01 01 01 01 01 01 01 01 01 01 01 01 01 01 01 01 01 01 13 
13 01 01 01 01 01 01 01 01 01 01 01 01 01 01 01 01 01 01 01 01 01 01 01 01 01 01 01 01 01 01 13 01 01 01 01 01 01 01 01 01 01 01 01 01 01 01 01 01 01 01 07 01 01 01 01 01 01 01 01 01 01 01 13 
13 01 01 01 01 01 01 01 01 01 01 01 01 01 01 01 01 01 01 01 01 01 01 01 01 01 01 01 01 01 01 17 01 01 01 01 01 01 01 01 01 01 01 01 01 01 01 01 01 01 01 13 01 01 01 01 01 01 01 01 01 01 01 13 
13 01 01 01 01 01 01 01 01 01 01 01 01 01 01 01 01 01 01 01 01 01 01 01 01 01 01 01 01 01 01 01 01 01 01 01 01 01 01 01 01 01 01 01 01 01 01 01 01 01 01 13 01 01 01 01 01 01 01 01 01 01 01 13 
13 01 01 01 01 01 01 01 01 01 01 01 01 01 01 01 01 01 01 01 01 01 01 01 01 01 01 01 01 01 01 01 01 01 01 01 01 01 01 01 01 01 01 01 01 01 01 01 01 01 01 13 01 01 01 06 09 09 18 01 01 16 09 19 
13 01 01 01 01 01 01 01 01 01 01 01 01 01 01 01 01 01 01 01 01 01 01 01 01 01 01 01 01 01 01 07 01 01 16 09 14 09 18 01 01 16 14 09 09 18 01 01 16 09 09 19 01 01 01 13 01 01 01 01 01 01 01 13 
03 09 08 01 01 01 01 01 01 01 01 01 01 01 01 01 01 01 01 01 01 01 01 01 01 01 01 01 01 01 01 13 01 01 01 01 13 01 01 01 01 01 13 01 01 01 01 01 01 01 01 13 01 01 01 13 01 01 01 01 01 01 01 13 
13 01 13 01 01 01 01 01 01 01 01 01 01 01 01 01 01 01 01 01 01 01 01 01 01 01 01 01 01 01 01 13 01 01 01 01 13 01 01 01 01 01 13 01 01 01 01 01 01 01 01 13 01 01 01 13 01 01 01 01 01 01 01 13 
13 01 13 01 01 01 01 01 01 01 01 01 01 01 01 01 01 01 01 01 01 01 06 09 09 09 09 01 01 09 09 19 01 01 01 01 13 01 01 01 01 01 13 01 01 01 01 01 01 01 01 13 01 01 01 13 01 01 01 01 01 01 01 13 
13 01 13 01 01 01 01 01 01 01 01 01 01 01 01 01 01 01 01 01 01 01 13 01 01 01 01 01 01 01 01 13 01 01 16 09 10 09 09 09 09 09 12 09 09 09 09 09 18 01 01 13 01 01 01 13 01 01 01 01 01 01 01 13 
13 01 13 01 01 01 01 01 01 01 01 01 01 01 01 01 01 01 01 01 01 01 13 01 01 01 01 01 01 01 01 13 01 01 01 01 01 01 01 01 01 01 13 01 01 01 01 01 01 01 01 13 01 01 01 13 01 01 01 01 01 01 01 13 
13 01 17 01 01 01 01 01 01 01 01 01 01 01 01 01 01 01 01 01 01 01 13 01 01 01 01 01 01 01 01 13 01 01 01 01 01 01 01 01 01 01 13 01 01 01 01 01 01 01 01 13 01 01 01 13 01 01 01 01 01 01 01 13 
13 01 01 01 01 01 01 01 01 01 01 01 01 01 01 01 01 01 01 01 01 01 13 01 01 01 01 01 01 01 01 13 01 01 01 01 01 01 01 01 01 01 13 01 01 01 01 01 01 01 01 13 01 01 01 13 01 01 01 01 01 01 01 13 
13 01 01 01 01 01 01 01 01 01 01 01 01 01 01 01 01 01 01 01 01 01 13 01 01 01 01 01 01 01 01 13 01 01 01 01 01 01 01 01 01 01 13 01 01 01 01 01 01 01 01 13 01 01 01 13 01 01 01 01 01 01 01 13 
13 01 07 01 01 01 01 01 01 01 01 01 01 01 01 01 01 01 01 01 01 01 13 01 01 01 01 01 01 01 01 13 01 01 01 01 01 01 01 01 01 01 03 09 09 18 01 01 01 01 01 13 01 01 01 13 01 01 01 01 01 01 01 13 
13 01 13 01 01 01 01 01 01 01 01 01 01 01 01 01 01 01 01 01 01 01 13 01 01 01 01 01 01 01 01 13 01 01 01 01 01 01 01 01 01 01 13 01 01 01 01 01 01 01 01 13 01 01 01 13 01 01 01 01 01 01 01 13 
13 01 13 01 01 01 01 01 01 06 18 01 01 16 09 09 09 09 09 09 09 09 10 09 09 18 01 01 16 09 09 10 09 09 09 09 09 14 18 01 01 16 10 09 09 09 09 09 09 09 09 05 01 01 16 10 09 09 09 09 09 09 09 13 
13 01 13 01 01 01 01 01 01 13 01 01 01 01 01 01 01 01 01 01 01 01 01 01 01 01 01 01 01 01 01 01 01 01 01 01 01 13 01 01 01 01 01 01 01 01 01 01 01 01 01 01 01 01 01 01 01 01 01 01 01 01 01 13 
13 01 13 01 01 01 01 01 01 13 01 01 01 01 01 01 01 01 01 01 01 01 01 01 01 01 01 01 01 01 01 01 01 01 01 01 01 13 01 01 01 01 01 01 01 01 01 01 01 01 01 01 01 01 01 01 01 01 01 01 01 01 01 13 
04 09 10 09 09 09 09 09 09 10 09 09 09 09 09 09 09 09 09 09 09 09 09 09 09 09 09 09 09 09 09 09 09 09 09 09 09 10 09 09 09 09 09 09 09 09 09 09 09 09 09 09 09 09 09 09 09 09 09 09 09 09 09 05


12
object 01 01 assets/Graphics/objects/computers/mainframe_5_animation.txt mainframe
object 04 01 assets/Graphics/objects/computers/mainframe_5_animation.txt mainframe
object 10 12 assets/Graphics/objects/npc/piano/piano_tl_animation.txt play
object 11 12 assets/Graphics/objects/npc/piano/piano_tr_animation.txt play
object 10 13 assets/Graphics/objects/npc/piano/piano_bl_animation.txt play
object 11 13 assets/Graphics/objects/npc/piano/piano_br_animation.txt play
object 08 12 assets/Graphics/objects/npc/drums/drum_tl_animation.txt drum
object 09 12 assets/Graphics/objects/npc/drums/drum_tr_animation.txt drum
object 08 13 assets/Graphics/objects/npc/drums/drum_bl_animation.txt drum
object 09 13 assets/Graphics/objects/npc/drums/drum_br_animation.txt drum
object 10 15 assets/Graphics/objects/npc/guitar/guitar_animation.txt guitar
sound 1
