7
64 38

06 09 09 09 09 14 09 09 09 09 09 09 09 09 14 09 09 09 09 09 09 09 09 14 09 09 09 09 09 09 09 09 14 09 09 09 09 09 09 09 09 09 09 09 09 09 09 09 09 14 09 14 09 14 09 09 14 09 09 14 09 14 09 08 
13 25 25 25 25 13 25 25 25 25 25 25 25 25 13 25 25 25 25 25 25 25 25 13 25 25 25 25 25 25 25 25 13 25 25 25 25 25 25 25 25 25 25 25 25 25 25 25 25 13 25 13 25 13 25 25 13 25 25 13 25 13 25 13 
13 00 00 00 00 17 00 00 00 00 00 00 00 00 17 00 00 00 00 00 00 00 00 17 00 00 00 00 00 00 00 00 13 00 00 00 00 00 00 00 23 00 00 00 00 00 00 00 00 13 00 13 00 13 00 00 13 00 00 13 00 13 00 13 
13 00 00 00 00 25 00 00 00 00 00 00 00 00 25 00 00 00 00 00 00 00 00 25 00 00 00 00 00 00 00 00 13 00 00 00 00 00 00 00 00 00 00 00 00 00 00 00 00 13 00 13 00 13 00 00 13 00 00 13 00 13 00 13 
13 00 00 00 00 00 00 00 00 00 00 00 00 00 00 00 00 00 00 00 00 00 00 00 00 00 00 00 00 00 00 00 13 00 00 00 00 00 00 00 00 00 00 00 00 00 00 00 00 13 00 00 00 00 00 00 13 00 00 00 00 00 00 13 
13 00 00 00 00 13 00 00 00 00 00 00 00 00 13 00 00 00 00 00 00 00 00 13 00 00 00 00 00 00 00 00 13 00 00 00 00 00 00 00 00 00 00 00 00 00 00 00 00 13 00 00 00 00 00 00 13 00 00 00 00 00 00 13 
13 00 00 00 00 13 00 00 21 00 00 00 00 00 13 00 00 00 00 00 00 00 00 13 00 00 00 00 00 00 00 00 13 00 00 00 00 00 00 00 00 00 00 00 00 00 00 00 00 04 09 09 18 00 00 16 10 18 00 00 16 09 09 13 
13 00 00 00 00 13 00 00 00 00 00 00 00 00 13 00 00 00 00 00 00 00 00 13 00 00 00 00 00 00 00 00 13 00 00 00 00 00 00 00 00 00 00 00 00 00 00 00 00 25 25 25 25 00 00 25 25 25 00 00 25 25 25 13 
13 00 00 00 00 13 00 00 00 00 00 00 00 00 13 00 00 00 00 00 00 00 00 13 00 00 00 00 00 00 00 00 13 00 00 00 00 00 00 00 00 00 00 00 00 00 00 00 00 00 00 00 00 00 00 00 00 00 00 00 00 00 00 13 
13 00 00 00 00 13 00 00 00 00 00 00 00 00 13 00 00 00 00 00 00 00 00 13 00 00 00 00 00 00 00 00 13 00 00 00 00 00 00 00 00 00 00 00 00 00 00 00 00 00 00 00 00 00 00 00 00 00 00 00 00 00 00 13 
13 00 00 00 00 13 00 00 00 00 00 00 00 00 13 00 00 00 00 00 00 00 00 13 00 00 00 00 00 00 00 00 13 00 00 00 00 06 09 09 09 09 09 09 09 09 09 09 09 09 09 09 09 09 09 09 09 09 18 00 00 16 09 19 
13 00 00 00 00 13 00 00 00 00 00 00 00 00 13 00 00 00 00 00 00 00 00 13 00 00 00 00 00 00 00 00 13 00 00 00 00 13 25 25 25 25 25 25 25 25 25 25 25 25 25 25 25 25 25 25 25 25 25 00 00 25 25 13 
13 00 00 00 00 13 00 00 00 00 00 00 00 00 13 00 00 00 00 00 00 00 00 13 00 00 00 00 00 00 00 00 13 00 00 00 00 13 00 00 00 00 00 00 00 00 00 00 00 00 00 00 00 00 00 00 00 00 00 00 00 00 00 13 
13 00 00 00 00 04 08 00 00 00 00 00 00 06 10 08 00 00 00 00 00 00 06 10 08 00 00 00 00 00 00 06 05 00 00 00 00 13 00 00 00 00 00 00 00 00 00 00 00 00 00 00 00 00 00 00 00 00 00 00 00 00 00 13 
13 00 00 00 00 25 04 08 00 00 00 00 06 05 25 04 08 00 00 00 00 06 05 25 04 08 00 00 00 00 06 05 25 00 00 00 00 13 00 00 00 00 00 00 00 00 00 00 00 00 00 00 00 00 00 00 00 00 00 00 00 00 00 19 
13 00 00 00 00 00 25 04 08 00 00 06 05 25 00 25 04 08 00 00 06 05 25 00 25 04 08 00 00 06 05 25 21 00 00 00 00 13 00 00 00 00 00 00 00 00 00 00 00 00 00 00 00 00 00 00 00 00 00 00 00 00 00 13 
13 00 00 00 00 00 00 25 17 00 00 17 25 00 00 00 25 17 00 00 17 25 00 00 00 25 17 00 00 17 25 00 00 00 00 00 00 13 00 00 00 00 00 00 00 00 00 00 00 00 00 00 00 00 00 00 00 00 00 00 00 00 00 13 
13 00 00 00 00 00 00 00 25 00 00 25 00 00 00 00 00 25 00 00 25 00 00 00 00 00 25 00 00 25 00 00 00 00 00 00 00 13 00 00 00 00 00 00 00 00 00 00 00 00 00 00 00 00 00 00 00 00 00 00 00 00 00 13 
13 00 00 00 00 00 00 00 00 00 00 00 00 00 00 00 00 00 00 00 00 00 00 00 00 00 00 00 00 00 00 00 00 00 00 00 00 13 00 00 00 00 00 00 00 00 00 00 00 00 00 00 00 00 00 00 00 00 00 00 00 00 00 13 
13 00 00 00 00 00 00 00 00 00 00 00 00 00 00 00 00 00 00 00 00 00 00 00 00 00 00 00 00 00 00 00 00 00 00 00 00 13 00 00 00 00 00 00 00 00 00 00 00 00 00 00 00 00 00 00 00 00 00 00 00 00 00 13 
13 00 00 00 00 00 00 00 07 00 00 07 00 00 00 00 00 07 00 00 07 00 00 00 00 00 07 00 00 07 00 00 00 00 00 00 00 13 00 00 00 00 00 00 00 00 00 00 00 00 00 00 00 00 00 00 00 00 00 00 00 00 00 13 
13 00 00 00 00 00 00 06 05 00 00 04 08 00 00 00 06 05 00 00 04 08 00 00 00 06 05 00 00 04 08 00 00 00 00 00 00 13 00 00 00 00 00 00 00 00 00 00 00 00 00 00 00 00 00 00 00 00 00 00 00 00 00 13 
13 00 00 00 00 00 06 05 25 00 00 25 04 08 00 06 05 25 00 00 25 04 08 00 06 05 25 00 00 25 04 08 00 00 00 00 00 13 00 00 00 00 00 00 00 00 00 00 00 00 00 00 00 00 00 00 00 00 00 00 00 00 00 13 
13 00 00 00 00 06 05 25 00 00 00 00 25 04 15 05 25 00 00 00 00 25 04 15 05 25 00 00 00 00 25 04 08 00 00 00 00 13 00 00 00 00 00 00 00 00 00 00 00 00 00 00 00 00 00 00 00 00 00 00 00 00 00 13 
13 00 00 00 00 13 25 00 00 00 00 00 00 25 13 25 00 00 00 00 00 00 25 13 25 00 00 00 00 00 00 25 13 00 00 00 00 13 00 00 00 00 00 00 00 00 00 00 00 00 00 00 00 00 00 00 00 00 00 00 00 00 00 13 
13 00 00 00 00 13 00 00 00 00 00 00 00 00 13 00 00 00 00 00 00 00 00 13 00 00 00 00 00 00 00 00 13 00 00 00 00 13 00 00 00 00 00 00 00 00 00 00 00 00 00 00 00 00 00 00 00 00 00 00 00 00 00 13 
13 00 00 00 00 13 00 00 00 00 00 00 00 00 13 00 00 00 00 00 00 00 00 13 00 00 00 00 00 00 00 00 13 00 00 00 00 13 00 00 00 00 00 00 00 00 00 00 00 00 00 00 00 00 00 00 00 00 00 00 00 00 00 13 
13 00 00 00 00 13 00 00 00 00 00 00 00 00 13 00 00 00 00 00 00 00 00 13 00 00 00 00 00 00 00 00 13 00 00 00 00 13 00 00 00 00 00 00 00 00 00 00 00 00 00 00 00 00 00 00 00 00 00 00 00 00 00 13 
13 00 00 00 00 13 00 00 00 00 00 00 00 00 13 00 00 00 00 00 00 00 00 13 00 00 00 00 00 00 00 00 13 00 00 00 00 13 00 00 00 00 00 00 00 00 00 00 00 00 00 00 00 00 00 00 00 00 00 00 00 00 00 13 
13 00 00 00 00 13 00 00 00 00 00 00 00 00 13 00 00 00 00 00 00 00 00 13 00 00 00 00 00 00 00 00 13 00 00 00 00 13 00 00 00 00 00 00 00 00 00 00 00 00 00 00 00 00 00 00 00 00 00 00 00 00 00 13 
13 00 00 00 00 13 00 00 00 00 00 00 00 00 13 00 00 00 00 00 00 00 00 13 00 00 00 00 00 00 00 00 13 00 00 00 00 13 00 00 00 00 00 00 00 00 00 00 00 00 00 00 00 00 00 00 00 00 00 00 00 00 00 13 
13 00 00 00 00 17 00 00 00 00 00 00 00 00 17 00 00 00 00 00 00 00 00 17 00 00 00 00 00 00 00 00 13 00 00 00 00 13 00 00 00 00 00 00 00 00 00 00 00 00 00 00 00 00 00 00 00 00 00 00 00 00 00 13 
13 00 00 00 00 25 00 00 00 00 00 00 00 00 25 00 00 00 00 00 00 00 00 25 00 00 00 00 00 00 00 00 13 00 00 00 00 17 00 00 00 00 00 00 00 00 00 00 00 00 00 00 00 00 00 00 00 00 00 00 00 00 00 13 
13 00 00 00 00 00 00 00 00 00 00 00 00 00 00 00 00 00 00 00 00 00 00 00 00 00 00 00 00 00 00 00 13 00 00 00 00 25 00 00 00 00 00 00 00 00 00 00 00 00 00 00 00 00 00 00 00 00 00 00 00 00 00 13 
13 00 00 00 00 13 00 00 00 00 00 00 00 00 13 00 00 00 00 00 00 00 00 13 00 00 00 00 00 00 00 00 13 00 00 00 00 00 00 00 00 00 00 00 00 00 00 00 00 00 00 00 00 00 00 00 00 00 00 00 00 00 00 13 
13 00 00 00 00 13 00 00 00 23 00 00 00 00 13 00 00 00 00 00 00 00 00 13 00 00 00 00 00 00 00 00 13 00 00 00 00 07 00 00 00 00 00 00 00 00 00 00 00 00 00 00 00 00 00 00 00 00 00 00 00 00 00 13 
04 09 09 09 09 10 09 09 09 09 09 09 09 09 10 09 09 09 09 09 09 09 09 10 09 09 09 09 09 09 09 09 10 09 09 09 10 09 09 09 09 09 09 09 09 09 09 09 09 09 09 09 09 09 09 09 09 09 09 09 09 09 09 05 
20 20 20 20 20 20 20 20 20 20 20 20 20 20 20 20 20 20 20 20 20 20 20 20 20 20 20 20 20 20 20 20 20 20 20 20 20 20 20 20 20 20 20 20 20 20 20 20 20 20 20 20 20 20 20 20 20 20 20 20 20 20 20 20 

8
stairs 08 06 15 24 6 l
stairs 32 15 47 32 6 l
stairs 40 02 45 04 8 l
stairs 09 35 04 32 8 l

objective 60 02 25 45 0 assets/Graphics/objects/png_object/object_animation.txt
objective 30 03 25 45 1 assets/Graphics/objects/png_object/object_animation.txt
objective 67 31 25 45 2 assets/Graphics/objects/png_object/object_animation.txt
objective 03 32 25 45 3 assets/Graphics/objects/png_object/object_animation.txt

