3
64 38

06 09 09 09 09 09 09 09 09 09 09 09 09 09 09 09 09 09 09 09 09 09 09 09 09 09 09 09 09 09 14 09 09 09 09 09 09 09 09 09 09 09 14 09 09 09 09 09 09 09 09 09 09 09 14 09 09 09 09 09 09 09 09 08 
13 20 20 20 20 20 20 20 20 20 20 20 20 20 20 20 20 20 20 20 20 20 20 20 20 20 20 20 20 20 17 20 20 20 20 20 20 20 20 20 20 20 13 20 20 20 20 20 20 20 20 20 20 20 17 20 20 20 20 20 20 20 20 13 
13 00 00 00 00 00 00 00 00 00 00 00 00 00 00 00 00 00 00 00 00 00 00 00 00 00 00 00 00 00 20 00 00 00 00 00 00 00 00 00 00 00 13 00 00 00 00 00 00 00 00 00 00 00 20 00 00 00 00 00 00 00 00 13 
13 00 00 00 00 00 06 09 18 01 16 08 00 00 00 00 00 00 00 00 00 00 00 00 00 00 00 00 00 00 00 00 00 00 00 00 00 00 00 00 00 00 17 00 00 00 00 00 00 00 00 00 00 00 00 00 00 00 00 00 00 00 00 13 
13 00 00 00 00 06 05 20 20 00 20 04 08 00 00 00 00 00 00 00 00 00 00 00 00 00 00 00 00 00 07 00 00 00 00 00 00 00 00 00 00 00 20 00 00 00 00 00 00 00 00 00 00 00 07 00 00 00 00 00 00 00 00 13 
13 00 00 00 00 13 20 00 00 00 00 20 17 00 00 00 00 00 00 00 00 00 00 00 00 00 00 00 00 00 13 00 00 00 00 00 00 00 00 00 00 00 00 00 00 00 00 00 00 00 00 00 00 00 13 00 00 00 00 00 00 00 00 13 
13 00 00 00 00 17 00 00 00 00 00 00 20 00 00 00 00 00 00 00 00 00 00 06 09 09 09 09 09 09 19 00 00 00 00 00 00 00 00 00 00 00 07 00 00 00 00 00 00 00 00 00 00 00 13 00 00 00 00 00 00 00 00 13 
13 00 00 00 00 20 00 00 00 23 00 00 00 00 00 00 00 00 00 00 00 00 06 05 20 20 20 20 20 20 03 09 09 09 09 09 09 09 09 09 09 09 09 09 09 09 09 09 09 09 09 09 09 09 05 00 00 00 00 00 00 00 00 13 
13 00 00 00 00 00 00 00 00 00 00 00 07 00 00 00 00 00 00 00 00 06 05 20 00 00 00 00 00 00 17 20 20 20 20 20 20 20 20 20 20 20 20 20 20 20 20 20 20 20 20 20 20 20 20 00 00 00 00 23 00 00 00 13 
13 00 00 00 00 07 00 00 00 00 00 00 13 00 00 00 00 00 00 00 16 05 20 00 00 00 00 00 00 00 20 00 00 00 00 00 00 00 00 00 00 00 00 00 00 00 00 00 00 00 00 00 00 00 00 00 00 00 00 00 00 00 00 13 
13 00 00 00 00 04 08 00 01 00 00 06 05 00 00 00 00 00 07 00 20 20 00 00 00 00 00 00 00 00 00 00 00 00 00 00 00 00 00 00 00 00 00 00 00 00 00 00 00 00 00 00 00 00 00 00 00 00 00 00 00 00 00 13 
13 00 00 00 00 20 04 18 00 16 09 05 20 00 00 00 00 00 13 00 00 00 00 00 00 00 00 00 00 00 06 09 09 18 00 16 14 09 09 18 00 16 14 09 18 00 16 09 08 00 16 09 09 09 08 00 00 00 00 00 00 00 00 13 
13 00 00 00 00 00 20 20 00 20 20 20 00 00 00 00 00 00 13 00 00 00 00 00 00 00 00 00 00 00 13 20 20 20 00 20 13 20 20 20 00 20 13 20 20 00 20 20 13 00 20 20 20 20 13 00 00 00 00 00 00 00 00 13 
13 00 00 00 00 00 00 00 00 00 00 00 00 00 00 00 00 00 13 00 00 00 00 00 00 00 00 00 00 00 13 00 00 00 00 00 13 00 00 00 00 00 13 00 00 00 00 00 13 00 00 00 00 00 13 00 00 00 00 00 00 00 00 13 
13 00 00 00 00 00 00 00 00 00 00 00 00 00 00 00 00 00 13 00 00 00 00 00 00 00 00 00 00 00 13 00 00 00 00 00 17 00 00 00 00 00 17 00 00 00 00 00 17 00 00 00 00 00 17 00 00 00 00 00 00 00 00 13 
13 00 00 00 00 00 00 00 00 00 00 00 00 00 00 00 00 00 13 00 00 00 00 00 00 00 00 00 00 00 13 00 00 00 00 00 20 00 00 00 00 00 20 00 00 00 00 00 20 00 00 00 00 00 20 00 00 00 00 00 00 00 00 13 
13 00 00 00 00 00 00 00 00 00 00 00 00 00 00 00 00 00 13 00 00 00 00 00 00 00 00 00 00 00 13 00 00 00 00 00 00 00 00 00 00 00 00 00 00 00 00 00 00 00 00 00 00 00 00 00 00 00 00 00 00 00 00 13 
13 00 00 00 00 00 00 00 00 00 00 00 00 00 00 00 00 00 13 00 00 00 00 00 00 00 00 00 00 00 03 09 09 09 09 09 09 09 09 09 09 09 09 09 09 09 09 09 09 09 09 09 09 09 08 00 00 00 00 00 00 00 00 13 
13 00 00 00 00 00 00 00 00 00 00 00 00 00 00 00 00 00 13 00 00 00 00 00 00 00 00 00 00 00 13 20 20 20 20 20 20 20 20 20 20 20 20 20 20 20 20 20 20 20 20 20 20 20 13 00 00 00 00 00 00 00 00 13 
13 00 00 00 00 00 00 00 00 00 00 00 00 00 00 00 00 00 13 00 00 00 00 00 00 00 00 00 00 00 13 00 00 00 00 00 00 00 00 00 00 00 00 00 00 00 00 00 00 00 00 00 00 00 13 00 00 00 00 00 00 00 00 13 
13 00 00 00 00 00 00 00 00 00 00 00 00 00 00 00 00 00 17 00 00 00 00 00 00 00 00 00 00 00 17 00 00 00 00 00 00 00 00 00 00 00 00 00 00 00 00 00 00 00 00 00 00 00 17 00 00 00 00 00 00 00 00 13 
13 00 00 00 00 00 06 09 18 00 16 08 00 00 00 00 00 00 20 00 16 09 08 00 00 00 00 00 00 00 20 00 00 00 00 00 00 00 00 00 00 00 00 00 00 00 00 00 00 00 00 00 00 00 20 00 00 00 00 00 00 00 00 13 
13 00 00 00 00 06 05 20 20 00 20 04 08 00 00 00 00 00 00 00 20 20 04 08 00 00 00 00 00 00 00 00 00 00 00 00 00 00 00 00 00 00 00 00 00 00 00 00 00 00 00 00 00 00 00 00 00 00 00 00 00 00 00 13 
13 00 00 00 00 17 20 00 00 00 00 20 13 00 00 00 00 00 00 00 00 00 20 04 08 00 00 00 00 00 07 00 16 09 09 09 09 09 09 09 09 09 09 09 09 08 00 00 00 00 00 00 00 00 00 00 00 00 00 00 00 00 00 13 
13 00 00 00 00 20 00 00 00 00 00 00 17 00 00 00 00 00 00 00 00 00 00 20 04 09 09 09 09 09 19 00 20 20 20 20 20 20 20 20 20 20 20 20 20 13 00 00 00 00 00 00 00 00 00 00 00 00 00 00 00 00 00 13 
13 00 00 00 00 01 00 21 00 00 00 00 20 00 00 00 00 00 00 00 00 00 00 00 20 20 20 20 20 20 13 00 00 00 00 01 00 00 00 00 01 00 00 00 00 13 00 00 00 00 00 00 00 00 00 00 00 00 00 00 00 00 00 13 
13 00 00 00 00 07 00 00 00 00 00 00 01 00 00 00 00 00 00 00 00 00 00 00 00 00 00 00 00 00 13 00 00 00 00 07 00 00 00 00 07 00 00 00 00 13 00 00 00 00 00 00 00 00 00 00 00 00 00 00 00 00 00 13 
13 00 00 00 00 13 00 00 00 00 00 00 07 00 00 00 00 00 00 00 00 00 00 00 00 00 00 00 00 00 13 00 00 00 00 13 00 00 00 00 13 00 00 00 00 17 00 00 06 09 09 09 09 09 08 00 16 15 18 00 16 09 09 19 
13 00 00 00 00 04 08 00 00 00 00 06 05 00 00 00 00 00 00 00 00 00 00 00 00 00 00 00 00 00 17 00 16 09 09 10 09 09 18 00 04 09 09 18 00 20 00 00 13 20 20 20 20 20 17 00 20 13 20 00 20 20 20 13 
13 00 00 00 00 20 04 18 01 16 09 05 20 00 00 00 00 00 00 00 00 00 00 00 00 00 00 00 00 00 20 00 20 20 20 20 20 20 20 00 20 20 20 20 00 00 00 00 13 00 00 00 00 00 20 00 00 13 00 00 00 00 00 13 
13 00 00 00 00 00 20 20 00 20 20 20 00 00 00 00 00 00 00 00 00 00 00 00 00 00 00 00 00 00 00 00 00 00 00 00 00 00 00 00 00 00 00 00 00 07 00 00 13 00 00 00 00 00 00 00 00 13 00 00 00 16 09 19 
13 00 00 00 00 00 00 00 00 00 00 00 00 00 00 00 00 00 00 00 00 00 00 00 00 00 00 00 00 00 07 00 16 09 09 15 09 09 18 00 06 09 09 18 00 13 00 00 13 00 21 00 00 00 16 09 09 19 00 00 00 20 20 13 
13 00 00 00 00 00 00 00 00 00 00 00 00 00 00 00 00 00 00 00 00 00 00 00 00 00 00 00 00 00 13 00 20 20 20 13 20 20 20 00 13 20 20 20 00 13 00 00 13 00 00 00 00 00 20 20 20 13 00 00 00 00 00 13 
13 00 00 00 00 00 00 00 00 00 00 00 00 00 00 00 00 00 00 00 00 00 00 00 00 00 00 00 00 00 13 00 00 00 00 17 00 00 00 00 17 00 00 00 00 13 00 00 13 00 00 00 00 00 00 00 00 13 00 00 00 16 09 19 
13 00 00 00 00 00 00 00 00 00 00 00 00 00 00 00 00 00 00 00 00 00 00 00 00 00 00 00 00 00 13 00 00 00 00 20 00 00 00 00 20 00 00 00 00 13 00 00 13 00 00 07 00 07 00 07 00 13 00 00 00 20 20 13 
13 00 00 00 00 00 00 00 00 00 00 00 00 00 00 00 00 00 00 00 00 00 00 00 00 00 00 00 00 00 13 00 00 00 00 00 00 00 00 00 00 00 00 00 00 13 00 00 13 00 00 13 00 13 00 13 00 13 00 00 00 00 00 13 
04 09 09 09 09 09 09 09 09 09 09 09 09 09 09 09 09 09 09 09 09 09 09 09 09 09 09 09 09 09 10 09 09 09 09 09 09 09 09 09 09 09 09 09 09 10 09 09 10 09 09 10 09 10 09 10 09 10 09 09 09 09 09 05 
20 20 20 20 20 20 20 20 20 20 20 20 20 20 20 20 20 20 20 20 20 20 20 20 20 20 20 20 20 20 20 20 20 20 20 20 20 20 20 20 20 20 20 20 20 20 20 20 20 20 20 20 20 20 20 20 20 20 20 20 20 20 20 20 

8
stairs 50 31 59 19 2 l
stairs 07 25 02 18 2 l
stairs 09 07 04	11 4 l
stairs 33 08 32 14 4 l

objective 02 06 25 45 0 assets/Graphics/objects/png_object/object_animation.txt
objective 17 32 25 45 1 assets/Graphics/objects/png_object/object_animation.txt
objective 51 02 25 45 2 assets/Graphics/objects/png_object/object_animation.txt
objective 57 24 25 45 3 assets/Graphics/objects/png_object/object_animation.txt
