0
64 38

06 09 09 09 09 09 09 09 09 09 09 09 09 09 09 09 09 09 09 09 09 09 09 09 09 09 09 09 09 09 14 09 09 09 09 09 09 09 09 09 09 09 14 09 09 09 09 09 09 09 09 09 09 09 14 09 09 09 09 09 09 09 09 08 
13 20 20 20 20 20 20 20 20 20 20 20 20 20 20 20 20 20 20 20 20 20 20 20 20 20 20 20 20 20 17 20 20 20 20 20 20 20 20 20 20 20 13 20 20 20 20 20 20 20 20 20 20 20 17 20 20 20 20 20 20 20 20 13 
13 00 00 00 00 00 00 00 00 00 00 00 00 00 00 00 00 00 00 00 00 00 00 00 00 00 00 00 00 00 20 00 00 00 00 00 00 00 00 00 00 00 13 00 00 00 00 00 00 00 00 00 00 00 20 00 00 00 00 00 00 00 00 13 
13 00 00 00 00 00 06 09 18 01 16 08 00 00 00 00 00 00 00 00 00 00 00 00 00 00 00 00 00 00 00 00 00 00 00 00 00 00 00 00 00 00 17 00 00 00 00 00 00 00 00 00 00 00 00 00 00 00 00 00 00 00 00 13 
13 00 00 00 00 06 05 20 20 00 20 04 08 00 00 00 00 00 00 00 00 00 00 00 00 00 00 00 00 00 07 00 00 00 00 00 00 00 00 00 00 00 20 00 00 00 00 00 00 00 00 00 00 00 07 00 00 00 00 00 00 00 00 13 
13 00 00 00 00 13 20 00 00 00 00 20 17 00 00 00 00 00 00 00 00 00 00 00 00 00 00 00 00 00 13 00 00 00 00 00 00 00 00 00 00 00 00 00 00 00 00 00 00 00 00 00 00 00 13 00 00 00 00 00 00 00 00 13 
13 00 00 00 00 17 00 00 00 00 00 00 20 00 00 00 00 00 00 00 00 00 00 06 09 09 09 09 09 09 19 00 00 00 00 00 00 00 00 00 00 00 07 00 00 00 00 00 00 00 00 00 00 00 13 00 00 00 00 00 00 00 00 13 
13 00 00 00 00 20 00 00 00 00 00 00 00 00 00 00 00 00 00 00 00 00 06 05 20 20 20 20 20 20 03 09 09 09 09 09 09 09 09 09 09 09 09 09 09 09 09 09 09 09 09 09 09 09 05 00 00 00 00 00 00 00 00 13 
13 00 00 00 00 00 00 00 00 00 00 00 07 00 00 00 00 00 00 00 00 06 05 20 00 00 00 00 00 00 17 20 20 20 20 20 20 20 20 20 20 20 20 20 20 20 20 20 20 20 20 20 20 20 20 00 00 00 00 00 00 00 00 13 
13 00 00 00 00 07 00 00 00 00 00 00 13 00 00 00 00 00 00 00 16 05 20 00 00 00 00 00 00 00 20 00 00 00 00 00 00 00 00 00 00 00 00 00 00 00 00 00 00 00 00 00 00 00 00 00 00 00 00 00 00 00 00 13 
13 00 00 00 00 04 08 00 01 00 00 06 05 00 00 00 00 00 07 00 20 20 00 00 00 00 00 00 00 00 00 00 00 00 00 00 00 00 00 00 00 00 00 00 00 00 00 00 00 00 00 00 00 00 00 00 00 00 00 00 00 00 00 13 
13 00 00 00 00 20 04 18 00 16 09 05 20 00 00 00 00 00 13 00 00 00 00 00 00 00 00 00 00 00 06 09 09 18 00 16 14 09 09 18 00 16 14 09 18 00 16 09 08 00 16 09 09 09 08 00 00 00 00 00 00 00 00 13 
13 00 00 00 00 00 20 20 00 20 20 20 00 00 00 00 00 00 13 00 00 00 00 00 00 00 00 00 00 00 13 20 20 20 00 20 13 20 20 20 00 20 13 20 20 00 20 20 13 00 20 20 20 20 13 00 00 00 00 00 00 00 00 13 
13 00 00 00 00 00 00 00 00 00 00 00 00 00 00 00 00 00 13 00 00 00 00 00 00 00 00 00 00 00 13 00 00 00 00 00 13 00 00 00 00 00 13 00 00 00 00 00 13 00 00 00 00 00 13 00 00 00 00 00 00 00 00 13 
13 00 00 00 00 00 00 00 00 00 00 00 00 00 00 00 00 00 13 00 00 00 00 00 00 00 00 00 00 00 13 00 00 00 00 00 17 00 00 00 00 00 17 00 00 00 00 00 17 00 00 00 00 00 17 00 00 00 00 00 00 00 00 13 
13 00 00 00 00 00 00 00 00 00 00 00 00 00 00 00 00 00 13 00 00 00 00 00 00 00 00 00 00 00 13 00 00 00 00 00 20 00 00 00 00 00 20 00 00 00 00 00 20 00 00 00 00 00 20 00 00 00 00 00 00 00 00 13 
13 00 00 00 00 00 00 00 00 00 00 00 00 00 00 00 00 00 13 00 00 00 00 00 00 00 00 00 00 00 13 00 00 00 00 00 00 00 00 00 00 00 00 00 00 00 00 00 00 00 00 00 00 00 00 00 00 00 00 00 00 00 00 13 
13 00 00 00 00 00 00 00 00 00 00 00 00 00 00 00 00 00 13 00 00 00 00 00 00 00 00 00 00 00 03 09 09 09 09 09 09 09 09 09 09 09 09 09 09 09 09 09 09 09 09 09 09 09 08 00 00 00 00 00 00 00 00 13 
13 00 00 00 00 00 00 00 00 00 00 00 00 00 00 00 00 00 13 00 00 00 00 00 00 00 00 00 00 00 13 20 20 20 20 20 20 20 20 20 20 20 20 20 20 20 20 20 20 20 20 20 20 20 13 00 00 00 00 00 00 00 00 13 
13 00 00 00 00 00 00 00 00 00 00 00 00 00 00 00 00 00 13 00 00 00 00 00 00 00 00 00 00 00 13 00 00 00 00 00 00 00 00 00 00 00 00 00 00 00 00 00 00 00 00 00 00 00 13 00 00 00 00 00 00 00 00 13 
13 00 00 00 00 00 00 00 00 00 00 00 00 00 00 00 00 00 17 00 00 00 00 00 00 00 00 00 00 00 17 00 00 00 00 00 00 00 00 00 00 00 00 00 00 00 00 00 00 00 00 00 00 00 17 00 00 00 00 00 00 00 00 13 
13 00 00 00 00 00 06 09 18 00 16 08 00 00 00 00 00 00 20 00 16 09 08 00 00 00 00 00 00 00 20 00 00 00 00 00 00 00 00 00 00 00 00 00 00 00 00 00 00 00 00 00 00 00 20 00 00 00 00 00 00 00 00 13 
13 00 00 00 00 06 05 20 20 00 20 04 08 00 00 00 00 00 00 00 20 20 04 08 00 00 00 00 00 00 00 00 00 00 00 00 00 00 00 00 00 00 00 00 00 00 00 00 00 00 00 00 00 00 00 00 00 00 00 00 00 00 00 13 
13 00 00 00 00 17 20 00 00 00 00 20 13 00 00 00 00 00 00 00 00 00 20 04 08 00 00 00 00 00 07 00 16 09 09 09 09 09 09 09 09 09 09 09 09 08 00 00 00 00 00 00 00 00 00 00 00 00 00 00 00 00 00 13 
13 02 02 00 00 20 00 00 00 00 00 00 17 00 00 00 00 00 00 00 00 00 00 20 04 09 09 09 09 09 19 00 20 20 20 20 20 20 20 20 20 20 20 20 20 13 00 00 00 00 00 00 00 00 00 00 00 00 00 00 00 00 00 13 
13 00 02 00 00 01 00 00 00 00 00 00 20 00 00 00 00 00 00 00 00 00 00 00 20 20 20 20 20 20 13 00 00 00 00 01 00 00 00 00 01 00 00 00 00 13 00 00 00 00 00 00 00 00 00 00 00 00 00 00 00 00 00 13 
13 00 02 00 00 07 00 00 00 00 00 00 01 00 00 00 00 00 00 00 00 00 00 00 00 00 00 00 00 00 13 00 00 00 00 07 00 00 00 00 07 00 00 00 00 13 00 00 00 00 00 00 00 00 00 00 00 00 00 00 00 00 00 13 
13 00 02 00 00 13 00 00 00 00 00 00 07 00 00 00 00 00 00 00 00 00 00 00 00 00 00 00 00 00 13 00 00 00 00 13 00 00 00 00 13 00 00 00 00 17 00 00 06 09 09 09 09 09 08 00 16 15 18 00 16 09 09 19 
13 00 02 00 00 04 08 00 00 00 00 06 05 00 00 00 00 00 00 00 00 00 00 00 00 00 00 00 00 00 17 00 16 09 09 10 09 09 18 00 04 09 09 18 00 20 00 00 13 20 20 20 20 20 17 00 20 13 20 00 20 20 20 13 
13 00 02 00 00 20 04 18 01 16 09 05 20 00 00 00 00 00 00 00 00 00 00 00 00 00 00 00 00 00 20 00 20 20 20 20 20 20 20 00 20 20 20 20 00 00 00 00 13 00 00 00 00 00 20 00 00 13 00 00 00 00 00 13 
13 00 02 00 00 00 20 20 00 20 20 20 00 00 00 00 00 00 00 00 00 00 00 00 00 00 00 00 00 00 00 00 00 00 00 00 00 00 00 00 00 00 00 00 00 07 00 00 13 00 00 00 00 00 00 00 00 13 00 00 00 16 09 19 
13 00 00 00 00 00 00 00 00 00 00 00 00 00 00 00 00 00 00 00 00 00 00 00 00 00 00 00 00 00 07 00 16 09 09 15 09 09 18 00 06 09 09 18 00 13 00 00 13 00 00 00 00 00 16 09 09 19 00 00 00 20 20 13 
13 02 02 00 00 00 00 00 00 00 00 00 00 00 00 00 00 00 00 00 00 00 00 00 00 00 00 00 00 00 13 00 20 20 20 13 20 20 20 00 13 20 20 20 00 13 00 00 13 00 00 00 00 00 20 20 20 13 00 00 00 00 00 13 
13 02 02 00 00 00 00 00 00 00 00 00 00 00 00 00 00 00 00 00 00 00 00 00 00 00 00 00 00 00 13 00 00 00 00 17 00 00 00 00 17 00 00 00 00 13 00 00 13 00 00 00 00 00 00 00 00 13 00 00 00 16 09 19 
13 02 02 00 00 00 00 00 00 00 00 00 00 00 00 00 00 00 00 00 00 00 00 00 00 00 00 00 00 00 13 00 00 00 00 20 00 00 00 00 20 00 00 00 00 13 00 00 13 00 00 07 00 07 00 07 00 13 00 00 00 20 20 13 
13 02 02 00 00 00 00 00 00 00 00 00 00 00 00 00 00 00 00 00 00 00 00 00 00 00 00 00 00 00 13 00 00 00 00 00 00 00 00 00 00 00 00 00 00 13 00 00 13 00 00 13 00 13 00 13 00 13 00 00 00 00 00 13 
04 09 09 09 09 09 09 09 09 09 09 09 09 09 09 09 09 09 09 09 09 09 09 09 09 09 09 09 09 09 10 09 09 09 09 09 09 09 09 09 09 09 09 09 09 10 09 09 10 09 09 10 09 10 09 10 09 10 09 09 09 09 09 05 
20 20 20 20 20 20 20 20 20 20 20 20 20 20 20 20 20 20 20 20 20 20 20 20 20 20 20 20 20 20 20 20 20 20 20 20 20 20 20 20 20 20 20 20 20 20 20 20 20 20 20 20 20 20 20 20 20 20 20 20 20 20 20 20 
