3
64 38

06 09 09 09 09 09 09 09 09 09 09 09 09 09 09 09 09 09 09 09 09 09 09 09 09 09 09 09 09 09 14 09 09 09 09 09 09 09 09 09 09 09 14 09 09 09 09 09 09 09 09 09 09 09 14 09 09 09 09 09 09 09 09 08 
13 25 25 25 25 25 25 25 25 25 25 25 25 25 25 25 25 25 25 25 25 25 25 25 25 25 25 25 25 25 17 25 25 25 25 25 25 25 25 25 25 25 13 25 25 25 25 25 25 25 25 25 25 25 17 25 25 25 25 25 25 25 25 13 
13 00 00 00 00 00 00 00 00 00 00 00 00 00 00 00 00 00 00 00 00 00 00 00 00 00 00 00 00 00 25 00 00 00 00 00 00 00 00 00 00 00 13 00 00 00 00 00 00 00 00 00 00 00 25 00 00 00 00 00 00 00 00 13 
13 00 00 00 00 00 06 09 18 01 16 08 00 00 00 00 00 00 00 00 00 00 00 00 00 00 00 00 00 00 00 00 00 00 00 00 00 00 00 00 00 00 17 00 00 00 00 00 00 00 00 00 00 00 00 00 00 00 00 00 00 00 00 13 
13 00 00 00 00 06 05 25 25 00 25 04 08 00 00 00 00 00 00 00 00 00 00 00 00 00 00 00 00 00 07 00 00 00 00 00 00 00 00 00 00 00 25 00 00 00 00 00 00 00 00 00 00 00 07 00 00 00 00 00 00 00 00 13 
13 00 00 00 00 13 25 00 00 00 00 25 17 00 00 00 00 00 00 00 00 00 00 00 00 00 00 00 00 00 13 00 00 00 00 00 00 00 00 00 00 00 00 00 00 00 00 00 00 00 00 00 00 00 13 00 00 00 00 00 00 00 00 13 
13 00 00 00 00 17 00 00 00 00 00 00 25 00 00 00 00 00 00 00 00 00 00 06 09 09 09 09 09 09 19 00 00 00 00 00 00 00 00 00 00 00 07 00 00 00 00 00 00 00 00 00 00 00 13 00 00 00 00 00 00 00 00 13 
13 00 00 00 00 25 00 00 00 23 00 00 00 00 00 00 00 00 00 00 00 00 06 05 25 25 25 25 25 25 03 09 09 09 09 09 09 09 09 09 09 09 09 09 09 09 09 09 09 09 09 09 09 09 05 00 00 00 00 00 00 00 00 13 
13 00 00 00 00 00 00 00 00 00 00 00 07 00 00 00 00 00 00 00 00 06 05 25 00 00 00 00 00 00 17 25 25 25 25 25 25 25 25 25 25 25 25 25 25 25 25 25 25 25 25 25 25 25 25 00 00 00 00 23 00 00 00 13 
13 00 00 00 00 07 00 00 00 00 00 00 13 00 00 00 00 00 00 00 16 05 25 00 00 00 00 00 00 00 25 00 00 00 00 00 00 00 00 00 00 00 00 00 00 00 00 00 00 00 00 00 00 00 00 00 00 00 00 00 00 00 00 13 
13 00 00 00 00 04 08 00 01 00 00 06 05 00 00 00 00 00 07 00 25 25 00 00 00 00 00 00 00 00 00 00 00 00 00 00 00 00 00 00 00 00 00 00 00 00 00 00 00 00 00 00 00 00 00 00 00 00 00 00 00 00 00 13 
13 00 00 00 00 25 04 18 00 16 09 05 25 00 00 00 00 00 13 00 00 00 00 00 00 00 00 00 00 00 06 09 09 18 00 16 14 09 09 18 00 16 14 09 18 00 16 09 08 00 16 09 09 09 08 00 00 00 00 00 00 00 00 13 
13 00 00 00 00 00 25 25 00 25 25 25 00 00 00 00 00 00 13 00 00 00 00 00 00 00 00 00 00 00 13 25 25 25 00 25 13 25 25 25 00 25 13 25 25 00 25 25 13 00 25 25 25 25 13 00 00 00 00 00 00 00 00 13 
13 00 00 00 00 00 00 00 00 00 00 00 00 00 00 00 00 00 13 00 00 00 00 00 00 00 00 00 00 00 13 00 00 00 00 00 13 00 00 00 00 00 13 00 00 00 00 00 13 00 00 00 00 00 13 00 00 00 00 00 00 00 00 13 
13 00 00 00 00 00 00 00 00 00 00 00 00 00 00 00 00 00 13 00 00 00 00 00 00 00 00 00 00 00 13 00 00 00 00 00 17 00 00 00 00 00 17 00 00 00 00 00 17 00 00 00 00 00 17 00 00 00 00 00 00 00 00 13 
13 00 00 00 00 00 00 00 00 00 00 00 00 00 00 00 00 00 13 00 00 00 00 00 00 00 00 00 00 00 13 00 00 00 00 00 25 00 00 00 00 00 25 00 00 00 00 00 25 00 00 00 00 00 25 00 00 00 00 00 00 00 00 13 
13 00 00 00 00 00 00 00 00 00 00 00 00 00 00 00 00 00 13 00 00 00 00 00 00 00 00 00 00 00 13 00 00 00 00 00 00 00 00 00 00 00 00 00 00 00 00 00 00 00 00 00 00 00 00 00 00 00 00 00 00 00 00 13 
13 00 00 00 00 00 00 00 00 00 00 00 00 00 00 00 00 00 13 00 00 00 00 00 00 00 00 00 00 00 03 09 09 09 09 09 09 09 09 09 09 09 09 09 09 09 09 09 09 09 09 09 09 09 08 00 00 00 00 00 00 00 00 13 
13 00 00 00 00 00 00 00 00 00 00 00 00 00 00 00 00 00 13 00 00 00 00 00 00 00 00 00 00 00 13 25 25 25 25 25 25 25 25 25 25 25 25 25 25 25 25 25 25 25 25 25 25 25 13 00 00 00 00 00 00 00 00 13 
13 00 00 00 00 00 00 00 00 00 00 00 00 00 00 00 00 00 13 00 00 00 00 00 00 00 00 00 00 00 13 00 00 00 00 00 00 00 00 00 00 00 00 00 00 00 00 00 00 00 00 00 00 00 13 00 00 00 00 00 00 00 00 13 
13 00 00 00 00 00 00 00 00 00 00 00 00 00 00 00 00 00 17 00 00 00 00 00 00 00 00 00 00 00 17 00 00 00 00 00 00 00 00 00 00 00 00 00 00 00 00 00 00 00 00 00 00 00 17 00 00 00 00 00 00 00 00 13 
13 00 00 00 00 00 06 09 18 00 16 08 00 00 00 00 00 00 25 00 16 09 08 00 00 00 00 00 00 00 25 00 00 00 00 00 00 00 00 00 00 00 00 00 00 00 00 00 00 00 00 00 00 00 25 00 00 00 00 00 00 00 00 13 
13 00 00 00 00 06 05 25 25 00 25 04 08 00 00 00 00 00 00 00 25 25 04 08 00 00 00 00 00 00 00 00 00 00 00 00 00 00 00 00 00 00 00 00 00 00 00 00 00 00 00 00 00 00 00 00 00 00 00 00 00 00 00 13 
13 00 00 00 00 17 25 00 00 00 00 25 13 00 00 00 00 00 00 00 00 00 25 04 08 00 00 00 00 00 07 00 16 09 09 09 09 09 09 09 09 09 09 09 09 08 00 00 00 00 00 00 00 00 00 00 00 00 00 00 00 00 00 13 
13 00 00 00 00 25 00 00 00 00 00 00 17 00 00 00 00 00 00 00 00 00 00 25 04 09 09 09 09 09 19 00 25 25 25 25 25 25 25 25 25 25 25 25 25 13 00 00 00 00 00 00 00 00 00 00 00 00 00 00 00 00 00 13 
13 00 00 00 00 01 00 21 00 00 00 00 25 00 00 00 00 00 00 00 00 00 00 00 25 25 25 25 25 25 13 00 00 00 00 01 00 00 00 00 01 00 00 00 00 13 00 00 00 00 00 00 00 00 00 00 00 00 00 00 00 00 00 13 
13 00 00 00 00 07 00 00 00 00 00 00 01 00 00 00 00 00 00 00 00 00 00 00 00 00 00 00 00 00 13 00 00 00 00 07 00 00 00 00 07 00 00 00 00 13 00 00 00 00 00 00 00 00 00 00 00 00 00 00 00 00 00 13 
13 00 00 00 00 13 00 00 00 00 00 00 07 00 00 00 00 00 00 00 00 00 00 00 00 00 00 00 00 00 13 00 00 00 00 13 00 00 00 00 13 00 00 00 00 17 00 00 06 09 09 09 09 09 08 00 16 15 18 00 16 09 09 19 
13 00 00 00 00 04 08 00 00 00 00 06 05 00 00 00 00 00 00 00 00 00 00 00 00 00 00 00 00 00 17 00 16 09 09 10 09 09 18 00 04 09 09 18 00 25 00 00 13 25 25 25 25 25 17 00 25 13 25 00 25 25 25 13 
13 00 00 00 00 25 04 18 01 16 09 05 25 00 00 00 00 00 00 00 00 00 00 00 00 00 00 00 00 00 25 00 25 25 25 25 25 25 25 00 25 25 25 25 00 00 00 00 13 00 00 00 00 00 25 00 00 13 00 00 00 00 00 13 
13 00 00 00 00 00 25 25 00 25 25 25 00 00 00 00 00 00 00 00 00 00 00 00 00 00 00 00 00 00 00 00 00 00 00 00 00 00 00 00 00 00 00 00 00 07 00 00 13 00 00 00 00 00 00 00 00 13 00 00 00 16 09 19 
13 00 00 00 00 00 00 00 00 00 00 00 00 00 00 00 00 00 00 00 00 00 00 00 00 00 00 00 00 00 07 00 16 09 09 15 09 09 18 00 06 09 09 18 00 13 00 00 13 00 21 00 00 00 16 09 09 19 00 00 00 25 25 13 
13 00 00 00 00 00 00 00 00 00 00 00 00 00 00 00 00 00 00 00 00 00 00 00 00 00 00 00 00 00 13 00 25 25 25 13 25 25 25 00 13 25 25 25 00 13 00 00 13 00 00 00 00 00 25 25 25 13 00 00 00 00 00 13 
13 00 00 00 00 00 00 00 00 00 00 00 00 00 00 00 00 00 00 00 00 00 00 00 00 00 00 00 00 00 13 00 00 00 00 17 00 00 00 00 17 00 00 00 00 13 00 00 13 00 00 00 00 00 00 00 00 13 00 00 00 16 09 19 
13 00 00 00 00 00 00 00 00 00 00 00 00 00 00 00 00 00 00 00 00 00 00 00 00 00 00 00 00 00 13 00 00 00 00 25 00 00 00 00 25 00 00 00 00 13 00 00 13 00 00 07 00 07 00 07 00 13 00 00 00 25 25 13 
13 00 00 00 00 00 00 00 00 00 00 00 00 00 00 00 00 00 00 00 00 00 00 00 00 00 00 00 00 00 13 00 00 00 00 00 00 00 00 00 00 00 00 00 00 13 00 00 13 00 00 13 00 13 00 13 00 13 00 00 00 00 00 13 
04 09 09 09 09 09 09 09 09 09 09 09 09 09 09 09 09 09 09 09 09 09 09 09 09 09 09 09 09 09 10 09 09 09 09 09 09 09 09 09 09 09 09 09 09 10 09 09 10 09 09 10 09 10 09 10 09 10 09 09 09 09 09 05 
20 20 20 20 20 20 20 20 20 20 20 20 20 20 20 20 20 20 20 20 20 20 20 20 20 20 20 20 20 20 20 20 20 20 20 20 20 20 20 20 20 20 20 20 20 20 20 20 20 20 20 20 20 20 20 20 20 20 20 20 20 20 20 20 

8
stairs 50 31 59 19 2 l
stairs 07 25 02 18 2 l
stairs 09 07 04	11 4 l
stairs 59 08 13 33 4 l

objective 02 06 25 45 0 assets/Graphics/objects/png_object/object_animation.txt
objective 17 32 25 45 1 assets/Graphics/objects/png_object/object_animation.txt
objective 51 02 25 45 2 assets/Graphics/objects/png_object/object_animation.txt
objective 57 24 25 45 3 assets/Graphics/objects/png_object/object_animation.txt
