5
64 38

06 09 09 09 09 09 09 09 09 09 09 09 09 09 09 09 09 09 09 09 09 09 09 09 09 09 09 09 09 09 09 09 09 09 09 09 09 09 09 09 09 09 09 09 09 09 09 09 09 09 09 09 09 09 09 09 09 09 09 09 09 09 09 08 
13 20 20 20 20 20 20 20 20 20 20 20 20 20 20 20 20 20 20 20 20 20 20 20 20 20 20 20 20 20 20 20 20 20 20 20 20 20 20 20 20 20 20 20 20 20 20 20 20 20 20 20 20 20 20 20 20 20 20 20 20 20 20 13 
13 00 00 00 00 00 00 00 00 00 00 00 00 00 00 00 00 00 00 00 00 00 00 00 00 00 00 00 00 00 00 00 00 00 00 00 00 00 00 00 00 00 00 00 00 00 00 00 00 00 00 00 00 00 00 00 00 00 00 00 00 00 00 13 
13 00 00 00 00 00 00 00 21 00 00 00 00 00 00 00 00 00 00 00 23 00 00 00 00 00 00 00 00 00 00 00 00 00 00 00 00 00 00 00 00 00 00 00 00 00 00 00 00 00 00 00 00 00 00 00 00 00 00 00 00 00 00 13 
13 02 02 00 00 00 00 00 00 00 00 00 00 00 00 00 00 00 00 00 00 00 00 00 00 00 00 00 00 00 00 00 00 00 00 00 00 00 00 00 00 00 00 00 00 00 00 00 00 00 00 00 00 00 00 00 00 00 00 00 00 00 00 13 
13 00 00 06 09 09 09 09 09 14 09 09 09 09 09 08 00 00 06 09 09 09 09 09 14 09 09 09 09 09 08 00 00 06 09 09 09 09 09 09 09 09 09 09 09 08 00 00 06 09 09 09 09 09 09 09 09 09 09 09 08 00 00 13 
13 00 00 13 20 20 20 20 20 13 20 20 20 20 20 13 00 00 13 20 20 20 20 20 13 20 20 20 20 20 13 00 00 13 20 20 20 20 20 20 20 20 20 20 20 13 00 00 13 20 20 20 20 20 20 20 20 20 20 20 13 00 00 13 
13 00 00 13 00 00 00 00 00 17 00 00 00 01 00 13 00 00 13 00 00 00 00 00 13 00 00 00 00 00 13 00 00 13 00 00 00 00 00 00 00 00 00 00 00 13 00 00 13 00 00 00 00 00 00 00 00 00 00 00 13 00 00 13 
13 00 00 13 00 00 00 00 00 20 00 00 00 01 00 13 00 00 17 00 00 00 00 00 13 00 00 00 00 00 13 00 00 13 00 00 00 00 00 07 00 00 00 00 00 13 00 00 13 00 00 00 00 00 07 00 00 00 00 00 13 00 00 13 
13 00 00 13 00 00 00 00 00 00 00 00 00 01 00 17 00 00 20 00 00 00 00 00 13 00 00 00 00 00 17 00 00 17 00 00 00 00 00 13 00 00 00 00 00 17 00 00 13 00 00 00 00 00 13 00 00 00 00 00 13 00 00 13 
13 00 00 13 01 01 01 01 00 07 00 00 00 01 00 20 00 00 00 00 00 00 00 00 13 00 00 00 00 00 20 00 00 20 00 00 00 00 00 13 00 00 00 00 00 20 00 00 13 00 00 00 00 00 13 00 00 00 00 00 13 00 00 13 
13 00 00 13 00 00 01 00 00 13 01 00 01 01 01 00 00 00 07 00 00 00 00 00 13 00 00 00 00 00 00 00 00 00 00 00 00 00 00 13 00 00 00 00 00 00 00 00 13 00 00 00 00 00 13 00 00 00 00 00 13 00 00 13 
13 00 00 04 09 18 00 16 09 10 18 00 16 09 09 18 00 00 04 09 09 09 18 00 17 00 16 09 09 09 18 00 00 16 09 09 09 09 09 12 09 09 09 09 09 18 00 00 13 00 16 09 09 09 12 09 09 09 18 00 17 00 00 13 
13 00 00 20 20 20 00 20 20 20 20 00 20 20 20 20 00 00 20 20 20 20 20 00 20 00 20 20 20 20 20 00 00 20 20 20 20 20 20 13 20 20 20 20 20 20 00 00 13 00 20 20 20 20 13 20 20 20 20 00 20 00 00 13 
13 00 00 01 00 00 00 00 00 00 00 00 00 00 00 00 00 00 00 00 00 00 00 00 00 00 00 00 00 00 00 00 00 00 00 00 00 00 00 13 00 00 00 00 00 00 00 00 13 00 00 00 00 00 13 00 00 00 00 00 00 00 00 13 
13 00 00 00 00 00 00 01 01 01 01 01 01 01 01 01 00 00 00 00 00 00 00 00 00 00 00 00 00 00 00 00 00 07 00 00 00 00 00 13 00 00 00 00 00 07 00 00 13 00 00 00 00 00 13 00 00 00 00 00 07 00 00 13 
13 00 00 06 09 18 00 16 09 14 18 01 16 09 09 08 00 00 07 00 16 09 09 09 09 09 09 09 09 09 18 00 00 13 00 00 00 00 00 13 00 00 00 00 00 13 00 00 17 00 00 00 00 00 13 00 00 00 00 00 13 00 00 13 
13 00 00 13 20 20 00 20 20 17 20 01 20 20 20 13 00 00 13 00 20 20 20 20 20 20 20 20 20 20 20 00 00 13 00 00 00 00 00 13 00 00 00 00 00 13 00 00 20 00 00 00 00 00 13 00 00 00 00 00 13 00 00 13 
13 00 00 13 00 00 00 00 00 20 00 00 00 00 00 13 00 00 13 00 00 00 00 00 00 00 00 00 00 00 00 00 00 13 00 00 00 00 00 13 00 00 00 00 00 13 00 00 00 00 00 00 00 00 13 00 00 00 00 00 13 00 00 13 
13 00 00 13 00 00 00 00 00 01 00 00 00 00 00 13 00 00 17 00 00 00 00 00 07 00 00 00 00 00 07 00 00 04 09 09 09 18 00 17 00 16 09 09 09 05 00 00 16 09 09 09 09 09 10 09 09 09 18 00 17 00 00 13 
13 00 00 13 00 00 00 00 00 07 00 00 00 00 00 17 00 00 20 00 00 00 00 00 13 00 00 00 00 00 13 00 00 20 20 20 20 20 00 20 00 20 20 20 20 20 00 00 20 20 20 20 20 20 20 20 20 20 20 00 20 00 00 13 
13 00 00 13 00 00 00 00 00 13 00 00 00 00 00 20 00 00 00 00 00 00 00 00 13 00 00 00 00 00 13 00 00 00 00 00 00 00 00 00 00 00 00 00 00 00 00 00 00 00 00 00 00 00 00 00 00 00 00 00 00 00 00 13 
13 00 00 13 00 00 00 00 00 13 00 00 00 00 00 01 00 00 07 00 00 00 00 00 13 00 00 00 00 00 13 00 00 00 00 00 00 00 00 00 00 00 00 00 00 00 00 00 00 00 00 00 00 00 00 00 00 00 00 00 00 00 00 13 
13 00 00 03 09 09 09 09 09 12 09 09 09 18 01 07 00 00 13 00 16 09 09 09 19 00 16 09 09 09 13 00 00 06 09 09 09 09 09 14 09 09 09 18 00 07 00 00 06 09 09 09 09 09 09 09 09 09 09 00 07 00 00 13 
13 00 00 13 20 20 20 20 20 17 20 20 20 20 01 13 00 00 13 00 20 20 20 20 13 00 20 20 20 20 13 00 00 13 20 20 20 20 20 13 20 20 20 20 00 13 00 00 13 20 20 20 20 20 20 20 20 20 20 00 13 00 00 13 
13 02 02 13 00 00 00 00 00 20 00 00 00 00 00 13 00 00 13 00 00 00 00 00 13 00 00 00 00 00 13 00 00 17 00 00 00 00 00 13 00 00 00 00 00 17 00 00 13 00 00 00 00 00 00 00 00 00 00 00 13 00 00 13 
13 00 02 13 00 00 00 00 00 01 00 00 00 00 00 13 00 00 13 00 00 00 00 00 17 00 00 00 00 00 13 00 00 20 00 01 00 00 00 13 01 00 00 00 00 20 00 00 13 00 00 00 00 00 07 00 00 00 00 00 13 00 00 13 
13 00 02 13 00 00 00 00 00 07 00 00 01 00 00 13 00 00 13 00 00 00 00 00 20 00 00 00 00 00 13 00 00 00 00 00 00 00 00 17 00 00 00 00 00 00 00 00 17 00 00 00 00 00 13 00 00 00 00 00 17 00 00 13 
13 00 02 13 00 00 00 00 00 13 00 00 00 00 00 13 00 00 13 00 00 00 00 00 00 00 00 00 00 00 13 00 00 07 00 00 00 00 00 20 00 00 00 00 00 07 00 00 20 00 00 00 00 00 13 00 00 00 00 00 20 00 00 13 
13 00 02 13 00 00 00 00 00 13 00 00 00 00 00 13 00 00 13 00 00 00 00 00 07 00 00 00 00 00 13 00 00 13 00 00 00 00 00 00 00 00 00 00 00 13 00 00 00 00 00 00 00 00 13 00 00 00 00 00 00 00 00 13 
13 00 02 04 09 09 09 18 01 04 09 09 09 18 00 17 00 00 04 09 09 09 18 00 17 00 16 09 09 09 05 00 00 04 09 09 09 09 09 09 09 09 09 09 09 05 00 00 16 09 09 09 09 09 10 09 09 09 09 09 18 00 00 13 
13 00 02 20 20 20 20 20 00 20 20 20 20 20 00 20 00 00 20 20 20 20 20 00 20 00 20 20 20 20 20 00 00 20 20 20 20 20 20 20 20 20 20 20 20 20 00 00 20 20 20 20 20 20 20 20 20 20 20 20 20 00 00 13 
13 00 00 00 00 00 00 00 00 00 00 00 00 00 00 00 00 00 00 00 00 00 00 00 00 00 00 00 00 00 00 00 00 00 00 00 00 00 00 00 00 00 00 00 00 00 00 00 00 00 00 00 00 00 00 00 00 00 00 00 00 00 00 13 
13 02 02 00 00 00 00 00 00 00 00 00 00 00 00 00 00 00 00 00 00 00 00 00 00 00 00 00 00 00 00 00 00 00 00 00 00 00 00 00 00 00 00 00 00 00 00 00 00 00 00 00 00 00 00 00 00 00 00 00 00 00 00 13 
13 02 02 00 00 00 00 00 00 00 00 00 00 00 00 00 00 00 00 00 00 00 00 00 00 00 00 00 00 00 00 00 00 00 00 00 00 00 00 00 00 00 00 00 00 00 00 00 00 00 23 00 00 00 00 00 00 21 00 00 00 00 00 13 
13 02 02 00 00 00 00 00 00 00 00 00 00 00 00 00 00 00 00 00 00 00 00 00 00 00 00 00 00 00 00 00 00 00 00 00 00 00 00 00 00 00 00 00 00 00 00 00 00 00 00 00 00 00 00 00 00 00 00 00 00 00 00 13 
04 09 09 09 09 09 09 09 09 09 09 09 09 09 09 09 09 09 09 09 09 09 09 09 09 09 09 09 09 09 09 09 09 09 09 09 09 09 09 09 09 09 09 09 09 09 09 09 09 09 09 09 09 09 09 09 09 09 09 09 09 09 09 05 
20 20 20 20 20 20 20 20 20 20 20 20 20 20 20 20 20 20 20 20 20 20 20 20 20 20 20 20 20 20 20 20 20 20 20 20 20 20 20 20 20 20 20 20 20 20 20 20 20 20 20 20 20 20 20 20 20 20 20 20 20 20 20 20 

8
stairs 08 03 15 08 4 l
stairs 57 34 09 33 4 l
stairs 20 03 56 05 6 l
stairs 50 34 28 18 6 l

objective 56 03 25 45 0 assets/Graphics/objects/png_object/object_animation.txt
objective 21 08 25 45 1 assets/Graphics/objects/png_object/object_animation.txt
objective 42 17 25 45 2 assets/Graphics/objects/png_object/object_animation.txt
objective 21 26 25 45 3 assets/Graphics/objects/png_object/object_animation.txt
