5
64 38

06 09 09 09 09 09 09 09 09 09 09 09 09 09 09 09 09 09 09 09 09 09 09 09 09 09 09 09 09 09 09 09 09 09 09 09 09 09 09 09 09 09 09 09 09 09 09 09 09 09 09 09 09 09 09 09 09 09 09 09 09 09 09 08 
13 25 25 25 25 25 25 25 25 25 25 25 25 25 25 25 25 25 25 25 25 25 25 25 25 25 25 25 25 25 25 25 25 25 25 25 25 25 25 25 25 25 25 25 25 25 25 25 25 25 25 25 25 25 25 25 25 25 25 25 25 25 25 13 
13 00 00 00 00 00 00 00 00 00 00 00 00 00 00 00 00 00 00 00 00 00 00 00 00 00 00 00 00 00 00 00 00 00 00 00 00 00 00 00 00 00 00 00 00 00 00 00 00 00 00 00 00 00 00 00 00 00 00 00 00 00 00 13 
13 00 00 00 00 00 00 00 21 00 00 00 00 00 00 00 00 00 00 00 00 00 00 00 00 00 00 00 00 00 00 00 00 00 00 00 00 00 00 00 00 00 00 00 00 00 00 00 00 00 00 00 00 00 00 00 00 00 00 00 00 00 00 13 
13 00 00 00 00 00 00 00 00 00 00 00 00 00 00 00 00 00 00 00 00 00 00 00 00 00 00 00 00 00 00 00 00 00 00 00 00 00 00 00 00 00 00 00 00 00 00 00 00 00 00 00 00 00 00 00 00 00 00 00 00 00 00 13 
13 00 00 06 09 09 09 09 09 14 09 09 18 00 16 08 00 00 06 09 09 09 09 09 14 09 09 09 09 09 08 00 00 06 09 09 09 09 09 09 09 09 09 09 09 08 00 00 06 18 00 16 09 09 09 09 09 09 09 09 08 00 00 13 
13 00 00 13 25 25 25 25 25 13 25 25 25 00 25 13 00 00 13 25 25 25 25 25 13 25 25 25 25 25 13 00 00 13 25 25 25 25 25 25 25 25 25 25 25 13 00 00 13 25 00 25 25 25 25 25 25 25 25 25 13 00 00 13 
13 00 00 13 00 00 00 00 00 17 00 00 00 00 00 13 00 00 13 00 00 00 00 00 13 00 00 00 00 00 13 00 00 13 00 00 00 00 00 00 00 00 00 00 00 13 00 00 13 00 00 00 00 00 00 00 00 00 00 00 13 00 00 13 
13 00 00 13 00 00 00 00 00 25 00 00 00 00 00 13 00 00 17 00 00 00 00 00 13 00 00 00 00 00 13 00 00 13 00 00 00 00 00 07 00 00 00 00 00 13 00 00 13 00 00 00 00 00 07 00 00 00 00 00 13 00 00 13 
13 00 00 13 00 00 00 00 00 00 00 00 00 00 00 17 00 00 25 00 00 00 00 00 13 00 00 00 00 00 17 00 00 17 00 00 00 00 00 13 00 00 00 00 00 17 00 00 13 00 00 00 00 00 13 00 00 00 00 00 13 00 00 13 
13 00 00 13 00 00 00 00 00 07 00 00 00 00 00 25 00 00 00 00 00 00 00 00 13 00 00 00 00 00 25 00 00 25 00 00 00 00 00 13 00 00 00 00 00 25 00 00 13 00 00 00 00 00 13 00 00 00 00 00 13 00 00 13 
13 00 00 13 00 00 00 00 00 13 00 00 00 00 00 00 00 00 07 00 00 00 00 00 13 00 00 00 00 00 00 00 00 00 00 00 00 00 00 13 00 00 00 00 00 00 00 00 13 00 00 00 00 00 13 00 00 00 00 00 13 00 00 13 
13 00 00 04 09 18 00 16 09 10 18 00 16 09 09 18 00 00 04 09 09 09 18 00 17 00 16 09 09 09 18 00 00 16 09 09 09 09 09 12 09 09 09 09 09 18 00 00 13 00 16 09 09 09 12 09 09 09 18 00 17 00 00 13 
13 00 00 25 25 25 00 25 25 25 25 00 25 25 25 25 00 00 25 25 25 25 25 00 25 00 25 25 25 25 25 00 00 25 25 25 25 25 25 13 25 25 25 25 25 25 00 00 13 00 25 25 25 25 13 25 25 25 25 00 25 00 00 13 
13 00 00 00 00 00 00 00 00 00 00 00 00 00 00 00 00 00 00 00 00 00 00 00 00 00 00 00 00 00 00 00 00 00 00 00 00 00 00 13 00 00 00 00 00 00 00 00 13 00 00 00 00 00 13 00 00 00 00 00 00 00 00 13 
13 00 00 00 00 00 00 00 00 00 00 00 00 00 00 00 00 00 00 00 00 00 00 00 00 00 00 00 00 00 00 00 00 07 00 00 00 00 00 13 00 00 00 00 00 07 00 00 13 00 00 00 00 00 13 00 00 00 00 00 07 00 00 13 
13 00 00 06 09 18 00 16 09 14 18 00 16 09 09 08 00 00 07 00 16 09 09 09 09 09 09 09 09 09 18 00 00 13 00 00 00 00 00 13 00 00 00 00 00 13 00 00 17 00 00 00 00 00 13 00 00 00 00 00 13 00 00 13 
13 00 00 13 25 25 00 25 25 17 25 00 25 25 25 13 00 00 13 00 25 25 25 25 25 25 25 25 25 25 25 00 00 13 00 00 00 00 00 13 00 00 00 00 00 13 00 00 25 00 00 00 00 00 13 00 00 00 00 00 13 00 00 13 
13 00 00 13 00 00 00 00 00 25 00 00 00 00 00 13 00 00 13 00 00 00 00 00 00 00 00 00 00 00 00 00 00 13 00 00 00 00 00 13 00 00 00 00 00 13 00 00 00 00 00 00 00 00 13 00 00 00 00 00 13 00 00 13 
13 00 00 13 00 00 00 00 00 00 00 00 00 00 00 13 00 00 17 00 00 00 00 00 07 00 00 00 00 00 07 00 00 04 09 09 09 18 00 17 00 16 09 09 09 05 00 00 16 09 09 09 09 09 10 09 09 09 18 00 17 00 00 13 
13 00 00 13 00 00 00 00 00 07 00 00 00 00 00 17 00 00 25 00 00 00 00 00 13 00 00 00 00 00 13 00 00 25 25 25 25 25 00 25 00 25 25 25 25 25 00 00 25 25 25 25 25 25 25 25 25 25 25 00 25 00 00 13 
13 00 00 13 00 00 00 00 00 13 00 00 00 00 00 25 00 00 00 00 00 00 00 00 13 00 00 00 00 00 13 00 00 00 00 00 00 00 00 00 00 00 00 00 00 00 00 00 00 00 00 00 00 00 00 00 00 00 00 00 00 00 00 13 
13 00 00 13 00 00 00 00 00 13 00 00 00 00 00 00 00 00 07 00 00 00 00 00 13 00 00 00 00 00 13 00 00 00 00 00 00 00 00 00 00 00 00 00 00 00 00 00 00 00 00 00 00 00 00 00 00 00 00 00 00 00 00 13 
13 00 00 03 09 09 09 09 09 12 09 09 09 18 00 07 00 00 13 00 16 09 09 09 19 00 16 09 09 09 19 00 00 06 09 09 09 09 09 14 09 09 09 18 00 07 00 00 06 09 09 09 09 09 09 09 09 09 09 00 07 00 00 13 
13 00 00 13 25 25 25 25 25 17 25 25 25 25 00 13 00 00 13 00 25 25 25 25 13 00 25 25 25 25 13 00 00 13 25 25 25 25 25 13 25 25 25 25 00 13 00 00 13 25 25 25 25 25 25 25 25 25 25 00 13 00 00 13 
13 00 00 13 00 00 00 00 00 25 00 00 00 00 00 13 00 00 13 00 00 00 00 00 13 00 00 00 00 00 13 00 00 17 00 00 00 00 00 13 00 00 00 00 00 17 00 00 13 00 00 00 00 00 00 00 00 00 00 00 13 00 00 13 
13 00 00 13 00 00 00 00 00 00 00 00 00 00 00 13 00 00 13 00 00 00 00 00 17 00 00 00 00 00 13 00 00 25 00 01 00 00 00 13 01 00 00 00 00 25 00 00 13 00 00 00 00 00 07 00 00 00 00 00 13 00 00 13 
13 00 00 13 00 00 00 00 00 07 00 00 00 00 00 13 00 00 13 00 00 00 00 00 25 00 00 00 00 00 13 00 00 00 00 00 00 00 00 17 00 00 00 00 00 00 00 00 17 00 00 00 00 00 13 00 00 00 00 00 17 00 00 13 
13 00 00 13 00 00 00 00 00 13 00 00 00 00 00 13 00 00 13 00 00 00 00 00 00 00 00 00 00 00 13 00 00 07 00 00 00 00 00 25 00 00 00 00 00 07 00 00 25 00 00 00 00 00 13 00 00 00 00 00 25 00 00 13 
13 00 00 13 00 00 00 00 00 13 00 00 00 00 00 13 00 00 13 00 00 00 00 00 07 00 00 00 00 00 13 00 00 13 00 00 00 00 00 00 00 00 00 00 00 13 00 00 00 00 00 00 00 00 13 00 00 00 00 00 00 00 00 13 
13 00 00 04 09 09 09 18 00 04 09 09 09 18 00 17 00 00 04 09 09 09 18 00 17 00 16 09 09 09 05 00 00 04 09 09 09 09 09 09 09 09 09 09 09 05 00 00 16 09 09 09 09 09 10 09 09 09 09 09 18 00 00 13 
13 00 00 25 25 25 25 25 00 25 25 25 25 25 00 25 00 00 25 25 25 25 25 00 25 00 25 25 25 25 25 00 00 25 25 25 25 25 25 25 25 25 25 25 25 25 00 00 25 25 25 25 25 25 25 25 25 25 25 25 25 00 00 13 
13 00 00 00 00 00 00 00 00 00 00 00 00 00 00 00 00 00 00 00 00 00 00 00 00 00 00 00 00 00 00 00 00 00 00 00 00 00 00 00 00 00 00 00 00 00 00 00 00 00 00 00 00 00 00 00 00 00 00 00 00 00 00 13 
13 00 00 00 00 00 00 00 00 00 00 00 00 00 00 00 00 00 00 00 00 00 00 00 00 00 00 00 00 00 00 00 00 00 00 00 00 00 00 00 00 00 00 00 00 00 00 00 00 00 00 00 00 00 00 00 00 00 00 00 00 00 00 13 
13 00 00 00 00 00 00 00 00 00 00 00 00 00 00 00 00 00 00 00 00 00 00 00 00 00 00 00 00 00 00 00 00 00 00 00 00 00 00 00 00 00 00 00 00 00 00 00 00 00 00 00 00 00 00 00 00 21 00 00 00 00 00 13 
13 00 00 00 00 00 00 00 00 00 00 00 00 00 00 00 00 00 00 00 00 00 00 00 00 00 00 00 00 00 00 00 00 00 00 00 00 00 00 00 00 00 00 00 00 00 00 00 00 00 00 00 00 00 00 00 00 00 00 00 00 00 00 13 
04 09 09 09 09 09 09 09 09 09 09 09 09 09 09 09 09 09 09 09 09 09 09 09 09 09 09 09 09 09 09 09 09 09 09 09 09 09 09 09 09 09 09 09 09 09 09 09 09 09 09 09 09 09 09 09 09 09 09 09 09 09 09 05 
20 20 20 20 20 20 20 20 20 20 20 20 20 20 20 20 20 20 20 20 20 20 20 20 20 20 20 20 20 20 20 20 20 20 20 20 20 20 20 20 20 20 20 20 20 20 20 20 20 20 20 20 20 20 20 20 20 20 20 20 20 20 20 20 

48
stairs 08 03 15 08 4 l
stairs 57 34 09 33 4 l

objective 56 03 25 45 0 assets/Graphics/objects/png_object/object_animation.txt
objective 20 08 25 45 1 assets/Graphics/objects/png_object/object_animation.txt
objective 42 17 25 45 2 assets/Graphics/objects/png_object/object_animation.txt
objective 20 26 25 45 3 assets/Graphics/objects/png_object/object_animation.txt

object 47 1.1 80 75 assets/Graphics/objects/png_object/object_animation.txt double_vending_80x75
object 32 1.1 58 75 assets/Graphics/objects/png_object/object_animation.txt vending_58x75

object 4.68 7.2 100 116 assets/Graphics/objects/png_object/object_animation.txt cubicle2_100x116
object 10.62 7.2 100 116 assets/Graphics/objects/png_object/object_animation.txt cubicle4_100x116

object 22.35 7.1 100 116 assets/Graphics/objects/png_object/object_animation.txt cubicle4_100x116
object 25.68 7.2 100 116 assets/Graphics/objects/png_object/object_animation.txt cubicle2_100x116

object 37.35 10.3 100 95 assets/Graphics/objects/png_object/object_animation.txt cubicle17_100x95
object 40.68 08.9 100 116 assets/Graphics/objects/png_object/object_animation.txt cubicle9_100x116
object 37.36 14.3 100 116 assets/Graphics/objects/png_object/object_animation.txt cubicle4_100x116
object 40.68 14.3 100 116 assets/Graphics/objects/png_object/object_animation.txt cubicle2_100x116

object 52.35 08.9 100 116 assets/Graphics/objects/png_object/object_animation.txt cubicle6_100x116
object 55.68 08.9 100 116 assets/Graphics/objects/png_object/object_animation.txt cubicle10_100x116
object 52.36 14.3 100 116 assets/Graphics/objects/png_object/object_animation.txt cubicle14_100x116
object 55.68 14.3 100 116 assets/Graphics/objects/png_object/object_animation.txt cubicle12_100x116

object 4.58 21.32 100 95 assets/Graphics/objects/png_object/object_animation.txt cubicle17_100x95
object 10.68 21.32 100 95 assets/Graphics/objects/png_object/object_animation.txt cubicle17_100x95
object 4.6 25.3 100 116 assets/Graphics/objects/png_object/object_animation.txt cubicle6_100x116
object 10.6 28.3 100 95 assets/Graphics/objects/png_object/object_animation.txt cubicle17_100x95

object 22.34 19.86 100 116 assets/Graphics/objects/png_object/object_animation.txt cubicle16_100x116
object 25.66 19.86 100 116 assets/Graphics/objects/png_object/object_animation.txt cubicle11_100x116
object 22.37 25.3 100 116 assets/Graphics/objects/png_object/object_animation.txt cubicle6_100x116
object 28.36 25.3 100 116 assets/Graphics/objects/png_object/object_animation.txt cubicle13_100x116

object 37.37 25.3 100 116 assets/Graphics/objects/png_object/object_animation.txt cubicle5_100x116
object 40.62 25.3 100 116 assets/Graphics/objects/png_object/object_animation.txt cubicle4_100x116

object 52.37 26.84 100 116 assets/Graphics/objects/png_object/object_animation.txt cubicle6_100x116
object 55.6 28.32 100 95 assets/Graphics/objects/png_object/object_animation.txt cubicle17_100x95

object 3 36.9 40 37 assets/Graphics/objects/png_object/object_animation.txt window_40x37
object 7 36.9 40 37 assets/Graphics/objects/png_object/object_animation.txt window_40x37
object 11 36.9 40 37 assets/Graphics/objects/png_object/object_animation.txt window_40x37
object 15 36.9 40 37 assets/Graphics/objects/png_object/object_animation.txt window_40x37
object 19 36.9 40 37 assets/Graphics/objects/png_object/object_animation.txt window_40x37
object 23 36.9 40 37 assets/Graphics/objects/png_object/object_animation.txt window_40x37
object 27 36.9 40 37 assets/Graphics/objects/png_object/object_animation.txt window_40x37
object 31 36.9 40 37 assets/Graphics/objects/png_object/object_animation.txt window_40x37
object 35 36.9 40 37 assets/Graphics/objects/png_object/object_animation.txt window_40x37
object 39 36.9 40 37 assets/Graphics/objects/png_object/object_animation.txt window_40x37
object 43 36.9 40 37 assets/Graphics/objects/png_object/object_animation.txt window_40x37
object 47 36.9 40 37 assets/Graphics/objects/png_object/object_animation.txt window_40x37
object 51 36.9 40 37 assets/Graphics/objects/png_object/object_animation.txt window_40x37
object 55 36.9 40 37 assets/Graphics/objects/png_object/object_animation.txt window_40x37
object 59 36.9 40 37 assets/Graphics/objects/png_object/object_animation.txt window_40x37
object 23 36.9 40 37 assets/Graphics/objects/png_object/object_animation.txt window_40x37
