2
64 38

06 09 09 09 09 15 09 09 09 09 09 09 09 09 09 09 15 09 09 09 09 09 09 09 09 09 09 09 09 09 09 15 09 09 09 09 09 09 09 09 09 09 09 09 09 09 09 09 09 09 15 09 09 09 09 09 15 09 09 09 09 09 09 08 
13 20 20 20 20 13 20 20 20 34 34 34 34 34 20 20 13 20 20 20 20 20 20 20 20 20 20 34 34 34 34 13 20 20 20 20 20 20 20 20 20 20 20 20 20 20 20 20 20 20 13 20 20 20 20 20 17 20 20 20 34 20 20 13 
13 00 00 00 00 13 28 29 30 35 35 35 35 35 29 30 13 00 00 00 00 00 00 29 30 29 30 35 35 35 35 13 28 00 00 00 00 00 00 00 00 00 00 00 00 00 00 00 00 00 13 28 00 00 00 00 20 28 26 27 35 00 00 13 
13 00 00 00 00 13 00 31 32 00 00 00 00 00 31 32 13 00 00 28 26 27 00 31 32 31 32 00 00 00 00 13 00 00 00 00 00 00 00 00 00 00 00 00 00 00 00 00 00 00 13 00 00 00 00 00 00 00 00 00 00 00 00 13 
13 00 00 00 00 13 00 33 00 00 00 00 00 00 33 00 13 00 00 00 00 00 00 33 00 33 00 00 00 00 00 13 00 00 00 00 07 00 00 00 00 00 00 00 00 00 00 07 00 00 13 00 00 00 00 00 00 00 00 00 00 29 30 13 
03 18 00 00 16 19 00 00 00 00 00 00 00 00 00 00 13 00 00 00 00 00 00 00 00 00 00 00 00 00 00 13 00 00 00 00 13 00 00 00 00 00 00 00 00 00 00 13 00 00 13 00 00 00 00 00 07 00 00 00 00 31 32 13 
13 20 00 00 20 13 00 00 00 00 00 00 00 00 00 00 13 00 00 00 00 00 00 00 00 00 00 00 00 00 00 13 00 00 00 00 13 00 00 00 00 00 00 00 00 00 00 13 00 00 13 00 00 00 00 00 13 00 00 00 00 33 00 13 
13 28 00 00 28 13 00 00 36 37 00 00 36 37 00 00 13 00 00 00 00 36 37 00 36 37 00 36 37 00 00 13 00 00 00 00 13 00 00 00 00 00 00 00 00 00 00 13 00 00 13 00 00 00 00 00 13 36 37 00 00 00 00 13 
13 28 00 00 28 13 00 00 00 00 00 00 00 00 00 00 13 00 00 00 00 00 00 00 00 00 00 00 00 00 00 13 00 00 00 00 13 00 00 00 00 00 00 00 00 00 00 13 00 00 17 00 00 00 00 00 13 29 30 00 00 00 00 13 
13 00 00 00 00 13 00 00 00 00 00 00 00 00 00 00 13 00 00 00 00 00 00 00 00 00 00 00 00 00 00 13 00 00 00 00 13 00 00 00 00 00 00 00 00 00 00 13 00 00 20 28 00 00 00 00 13 31 32 00 00 00 00 13 
13 00 00 00 00 04 09 09 09 09 09 09 09 18 00 00 17 00 00 00 16 09 09 09 09 09 09 09 09 09 09 05 00 00 00 00 13 00 00 00 00 00 00 00 00 00 00 13 00 00 00 00 00 00 00 00 13 33 00 00 00 29 30 13 
13 00 00 00 00 20 20 20 20 20 20 20 20 20 00 00 20 00 00 00 20 20 20 20 20 20 20 20 20 20 20 20 00 00 00 00 13 00 00 00 00 00 00 00 00 00 00 13 00 00 00 00 00 00 00 00 13 00 00 00 00 31 32 13 
13 00 00 00 00 00 00 00 00 00 00 00 00 00 00 00 00 00 00 00 00 00 00 00 00 00 00 00 00 00 00 00 00 00 00 00 03 09 09 09 09 18 00 00 16 09 09 10 09 09 09 08 00 00 00 00 13 00 00 00 00 33 00 13 
13 00 00 00 00 00 00 00 00 00 00 00 00 00 00 00 00 00 00 00 00 00 00 00 00 00 00 00 00 00 00 00 00 00 00 00 13 20 20 20 20 20 00 00 20 20 20 20 20 20 20 13 00 00 00 00 13 00 00 00 00 00 00 13 
13 00 00 00 00 00 00 00 00 00 00 00 00 00 00 00 00 00 00 00 00 00 00 00 00 00 00 00 00 00 00 00 00 00 00 28 13 00 00 00 00 00 00 00 00 00 00 00 00 00 28 13 00 00 00 00 04 18 00 00 00 16 09 19 
13 00 00 00 00 00 00 00 00 00 00 00 00 00 00 00 00 00 00 00 00 00 00 00 00 00 00 00 00 00 06 09 09 09 09 09 05 00 00 00 00 00 00 00 00 00 00 00 00 00 00 13 00 00 00 28 20 20 00 00 00 20 20 13 
13 00 00 22 00 00 00 00 00 00 00 00 00 00 00 00 00 00 00 00 00 00 00 00 00 00 00 00 00 00 13 20 20 20 20 20 20 00 00 00 00 00 00 00 00 00 00 00 00 00 00 13 00 00 00 00 00 00 00 00 00 00 00 13 
13 00 00 00 00 00 00 00 00 00 00 00 00 00 00 00 00 00 00 00 00 00 00 00 00 00 00 00 00 00 13 28 28 00 00 00 00 00 00 00 00 00 00 00 00 00 00 00 00 00 00 13 00 00 00 00 00 00 00 00 22 00 00 13 
13 00 00 24 00 00 00 06 09 09 09 09 09 09 08 00 00 00 00 00 00 00 00 00 00 00 00 00 00 00 13 00 00 00 00 00 00 00 00 00 00 00 00 00 00 00 00 00 00 00 00 13 00 00 00 00 00 00 00 00 00 00 00 13 
13 00 00 00 00 00 00 13 20 20 20 34 20 20 13 00 00 00 00 00 00 00 00 00 00 00 00 00 00 00 17 00 00 00 00 00 16 09 09 15 09 18 00 00 00 00 00 00 00 00 00 13 28 00 00 00 00 00 00 00 24 00 00 13 
13 00 00 00 00 00 00 13 36 37 00 35 29 30 13 00 00 00 00 00 00 00 00 00 00 00 00 00 00 00 20 00 00 00 00 00 20 20 20 13 20 20 00 00 00 00 00 00 00 00 00 00 00 00 00 00 00 00 00 00 00 00 00 13 
13 00 00 00 00 00 00 13 00 00 00 00 31 32 13 00 00 00 00 00 00 00 00 00 00 00 00 00 00 00 00 00 00 00 00 00 00 00 00 13 00 00 00 00 00 00 00 00 00 00 00 00 00 00 00 00 00 00 00 00 00 00 00 13 
13 00 00 00 00 00 00 13 00 00 00 00 33 00 13 00 00 00 00 00 00 00 00 00 00 00 00 00 00 00 00 00 00 00 00 00 00 00 00 13 00 00 00 00 00 00 00 00 00 00 00 07 28 00 00 00 00 00 00 00 00 00 00 13 
13 00 00 00 00 00 00 13 00 28 00 00 28 00 13 00 00 00 00 00 00 00 00 00 00 00 00 00 00 00 07 00 00 00 00 00 16 09 09 10 09 09 09 15 09 09 09 09 09 09 09 05 00 00 00 28 06 09 18 00 00 16 09 19 
03 09 09 08 00 00 00 04 09 18 00 00 16 09 05 00 00 00 00 00 00 00 00 00 00 00 00 00 00 00 13 00 00 00 00 00 20 20 20 20 20 34 34 13 20 20 20 34 20 20 20 20 00 00 00 00 13 34 20 00 00 20 34 13 
13 20 20 13 00 00 00 20 20 20 00 00 20 20 20 00 00 00 00 00 00 00 00 00 00 00 00 00 00 00 13 00 00 00 00 00 00 00 00 29 30 35 35 13 26 27 28 35 00 00 00 00 00 00 00 00 13 35 00 00 00 00 35 13 
13 28 00 13 00 00 00 00 00 00 00 00 00 00 00 00 00 00 00 00 00 00 00 07 00 00 00 00 00 00 04 09 09 09 09 08 00 00 00 31 32 00 00 17 00 00 00 00 00 00 00 00 00 00 00 00 13 00 28 00 00 28 00 13 
13 00 00 13 00 00 00 00 00 00 00 00 00 00 00 00 00 00 00 00 00 00 00 13 00 00 00 00 00 00 20 20 20 20 20 13 00 00 00 33 00 00 00 20 00 00 00 00 00 00 00 07 00 00 00 00 13 00 00 00 00 00 00 13 
13 00 00 13 00 00 00 00 00 00 00 00 00 00 00 00 00 00 00 00 00 00 00 13 00 00 00 00 00 00 00 00 00 28 28 13 00 00 00 00 00 00 00 00 00 00 00 00 00 29 30 13 00 00 00 00 13 00 00 00 00 00 00 13 
13 00 00 13 00 00 00 00 00 00 00 00 00 00 00 00 00 00 00 00 00 00 00 13 00 00 00 00 00 00 00 00 00 00 28 13 00 00 00 00 00 00 00 00 00 00 00 00 00 31 32 13 00 00 00 00 13 00 00 00 00 00 00 13 
13 00 00 17 00 00 00 00 00 00 00 00 00 00 00 00 00 00 00 00 00 00 00 13 00 00 00 00 00 00 00 00 00 00 00 13 00 00 00 00 00 00 00 07 00 00 00 00 00 33 00 13 00 00 00 00 13 00 00 00 00 00 00 13 
13 00 00 20 00 00 00 00 00 00 00 00 00 00 00 00 00 00 00 00 00 00 00 13 00 00 00 00 00 00 00 00 00 00 00 17 00 00 00 00 00 00 28 13 28 00 00 00 00 00 00 13 00 00 00 00 13 00 00 36 37 00 00 13 
13 00 00 00 00 00 00 00 00 07 00 00 00 00 07 00 00 00 00 00 00 00 00 13 00 00 00 00 00 00 00 00 00 00 00 20 00 00 16 09 09 09 09 10 09 09 09 09 09 09 09 05 00 00 00 16 19 00 00 00 00 00 00 13 
13 00 00 00 00 00 00 00 00 13 00 00 00 00 13 00 00 00 00 00 00 00 00 13 00 00 00 00 00 00 00 00 00 00 00 00 00 00 20 20 20 20 20 20 20 20 20 20 20 20 20 20 00 00 00 20 13 00 00 29 30 00 00 13 
13 00 00 07 00 00 00 00 00 13 00 00 00 00 13 00 00 00 00 00 00 00 00 13 00 00 00 00 00 00 00 00 00 00 00 00 00 00 00 00 00 00 00 00 00 00 00 00 00 00 00 00 00 00 00 00 13 00 00 31 32 00 00 13 
13 28 00 13 28 00 00 00 28 13 28 00 00 28 13 28 00 00 00 00 00 00 28 13 28 00 00 00 00 00 00 00 00 00 00 07 00 00 00 00 00 00 00 00 00 00 00 00 00 00 00 00 00 00 00 00 13 28 00 33 00 00 28 13 
04 09 09 10 09 09 09 09 09 10 09 09 09 09 10 09 09 09 09 09 09 09 09 10 09 09 09 09 09 09 09 09 09 09 09 10 09 09 09 09 09 09 09 09 09 09 09 09 09 09 09 09 09 09 09 09 10 09 09 09 09 09 09 05 
20 20 20 20 20 20 20 20 20 20 20 20 20 20 20 20 20 20 20 20 20 20 20 20 20 20 20 20 20 20 20 20 20 20 20 20 20 20 20 20 20 20 20 20 20 20 20 20 20 20 20 20 20 20 20 20 20 20 20 20 20 20 20 20 

4
stairs 03 17 1.5 02 1 r
stairs 60 17 35.5 37 1 r
stairs 03 19 7.5 26 3 r
stairs 60 19 50.5 31 3 l

object 20 9 40 40 assets/Graphics/objects/png_object/object_animation.txt clock_40x40
