2
64 38

06 09 09 09 09 15 09 09 09 09 09 09 09 09 09 09 15 09 09 09 09 09 09 09 09 09 09 09 09 09 09 15 09 09 09 09 09 09 09 09 09 09 09 09 09 09 09 09 09 09 15 09 09 09 09 09 15 09 09 09 09 09 09 08 
13 25 25 25 25 13 25 25 25 25 25 25 25 25 25 25 13 25 25 25 25 25 25 25 25 25 25 25 25 25 25 13 25 25 25 25 25 25 25 25 25 25 25 25 25 25 25 25 25 25 13 25 25 25 25 25 17 25 25 25 25 25 25 13 
13 00 00 00 00 13 00 00 00 00 00 00 00 00 00 00 13 00 00 00 00 00 00 00 00 00 00 00 00 00 00 13 00 00 00 00 00 00 00 00 00 00 00 00 00 00 00 00 00 00 13 00 00 00 00 00 25 00 00 00 00 00 00 13 
13 00 00 00 00 13 00 00 00 00 00 00 00 00 00 00 13 00 00 00 00 00 00 00 00 00 00 00 00 00 00 13 00 00 00 00 00 00 00 00 00 00 00 00 00 00 00 00 00 00 13 00 00 00 00 00 00 00 00 00 00 00 00 13 
13 00 00 00 00 13 00 00 00 00 00 00 00 00 00 00 13 00 00 00 00 00 00 00 00 00 00 00 00 00 00 13 00 00 00 00 07 00 00 00 00 00 00 00 00 00 00 07 00 00 13 00 00 00 00 00 00 00 00 00 00 00 00 13 
03 18 00 00 16 19 00 00 00 00 00 00 00 00 00 00 13 00 00 00 00 00 00 00 00 00 00 00 00 00 00 13 00 00 00 00 13 00 00 00 00 00 00 00 00 00 00 13 00 00 13 00 00 00 00 00 07 00 00 00 00 00 00 13 
13 25 00 00 25 13 00 00 00 00 00 00 00 00 00 00 13 00 00 00 00 00 00 00 00 00 00 00 00 00 00 13 00 00 00 00 13 00 00 00 00 00 00 00 00 00 00 13 00 00 13 00 00 00 00 00 13 00 00 00 00 00 00 13 
13 00 00 00 00 13 00 00 00 00 00 00 00 00 00 00 13 00 00 00 00 00 00 00 00 00 00 00 00 00 00 13 00 00 00 00 13 00 00 00 00 00 00 00 00 00 00 13 00 00 13 00 00 00 00 00 13 00 00 00 00 00 00 13 
13 00 00 00 00 13 00 00 00 00 00 00 00 00 00 00 13 00 00 00 00 00 00 00 00 00 00 00 00 00 00 13 00 00 00 00 13 00 00 00 00 00 00 00 00 00 00 13 00 00 17 00 00 00 00 00 13 00 00 00 00 00 00 13 
13 00 00 00 00 13 00 00 00 00 00 00 00 00 00 00 13 00 00 00 00 00 00 00 00 00 00 00 00 00 00 13 00 00 00 00 13 00 00 00 00 00 00 00 00 00 00 13 00 00 25 00 00 00 00 00 13 00 00 00 00 00 00 13 
13 00 00 00 00 04 09 09 09 09 09 09 09 18 00 00 17 00 00 00 16 09 09 09 09 09 09 09 09 09 09 05 00 00 00 00 13 00 00 00 00 00 00 00 00 00 00 13 00 00 00 00 00 00 00 00 13 00 00 00 00 00 00 13 
13 00 00 00 00 25 25 25 25 25 25 25 25 25 00 00 25 00 00 00 25 25 25 25 25 25 25 25 25 25 25 25 00 00 00 00 13 00 00 00 00 00 00 00 00 00 00 13 00 00 00 00 00 00 00 00 13 00 00 00 00 00 00 13 
13 00 00 00 00 00 00 00 00 00 00 00 00 00 00 00 00 00 00 00 00 00 00 00 00 00 00 00 00 00 00 00 00 00 00 00 03 09 09 09 09 18 00 00 16 09 09 10 09 09 09 08 00 00 00 00 13 00 00 00 00 00 00 13 
13 00 00 00 00 00 00 00 00 00 00 00 00 00 00 00 00 00 00 00 00 00 00 00 00 00 00 00 00 00 00 00 00 00 00 00 13 25 25 25 25 25 00 00 25 25 25 25 25 25 25 13 00 00 00 00 13 00 00 00 00 00 00 13 
13 00 00 00 00 00 00 00 00 00 00 00 00 00 00 00 00 00 00 00 00 00 00 00 00 00 00 00 00 00 00 00 00 00 00 00 13 00 00 00 00 00 00 00 00 00 00 00 00 00 00 13 00 00 00 00 04 18 00 00 00 16 09 19 
13 00 00 00 00 00 00 00 00 00 00 00 00 00 00 00 00 00 00 00 00 00 00 00 00 00 00 00 00 00 06 09 09 09 09 09 05 00 00 00 00 00 00 00 00 00 00 00 00 00 00 13 00 00 00 00 25 25 00 00 00 25 25 13 
13 00 00 22 00 00 00 00 00 00 00 00 00 00 00 00 00 00 00 00 00 00 00 00 00 00 00 00 00 00 13 25 25 25 25 25 25 00 00 00 00 00 00 00 00 00 00 00 00 00 00 13 00 00 00 00 00 00 00 00 00 00 00 13 
13 00 00 00 00 00 00 00 00 00 00 00 00 00 00 00 00 00 00 00 00 00 00 00 00 00 00 00 00 00 13 00 00 00 00 00 00 00 00 00 00 00 00 00 00 00 00 00 00 00 00 13 00 00 00 00 00 00 00 00 22 00 00 13 
13 00 00 24 00 00 00 06 09 09 09 09 09 09 08 00 00 00 00 00 00 00 00 00 00 00 00 00 00 00 13 00 00 00 00 00 00 00 00 00 00 00 00 00 00 00 00 00 00 00 00 13 00 00 00 00 00 00 00 00 00 00 00 13 
13 00 00 00 00 00 00 13 25 25 25 25 25 25 13 00 00 00 00 00 00 00 00 00 00 00 00 00 00 00 17 00 00 00 00 00 16 09 09 15 09 18 00 00 00 00 00 00 00 00 00 13 00 00 00 00 00 00 00 00 24 00 00 13 
13 00 00 00 00 00 00 13 00 00 00 00 00 00 13 00 00 00 00 00 00 00 00 00 00 00 00 00 00 00 25 00 00 00 00 00 25 25 25 13 25 25 00 00 00 00 00 00 00 00 00 00 00 00 00 00 00 00 00 00 00 00 00 13 
13 00 00 00 00 00 00 13 00 00 00 00 00 00 13 00 00 00 00 00 00 00 00 00 00 00 00 00 00 00 00 00 00 00 00 00 00 00 00 13 00 00 00 00 00 00 00 00 00 00 00 00 00 00 00 00 00 00 00 00 00 00 00 13 
13 00 00 00 00 00 00 13 00 00 00 00 00 00 13 00 00 00 00 00 00 00 00 00 00 00 00 00 00 00 00 00 00 00 00 00 00 00 00 13 00 00 00 00 00 00 00 00 00 00 00 07 00 00 00 00 00 00 00 00 00 00 00 13 
13 00 00 00 00 00 00 13 00 00 00 00 00 00 13 00 00 00 00 00 00 00 00 00 00 00 00 00 00 00 07 00 00 00 00 00 16 09 09 10 09 09 09 15 09 09 09 09 09 09 09 05 00 00 00 00 06 09 18 00 00 16 09 19 
03 09 09 08 00 00 00 04 09 18 00 00 16 09 05 00 00 00 00 00 00 00 00 00 00 00 00 00 00 00 13 00 00 00 00 00 25 25 25 25 25 25 25 13 25 25 25 25 25 25 25 25 00 00 00 00 13 25 25 00 00 25 25 13 
13 25 25 13 00 00 00 25 25 25 00 00 25 25 25 00 00 00 00 00 00 00 00 00 00 00 00 00 00 00 13 00 00 00 00 00 00 00 00 00 00 00 00 13 00 00 00 00 00 00 00 00 00 00 00 00 13 00 00 00 00 00 00 13 
13 00 00 13 00 00 00 00 00 00 00 00 00 00 00 00 00 00 00 00 00 00 00 07 00 00 00 00 00 00 04 09 09 09 09 08 00 00 00 00 00 00 00 17 00 00 00 00 00 00 00 00 00 00 00 00 13 00 00 00 00 00 00 13 
13 00 00 13 00 00 00 00 00 00 00 00 00 00 00 00 00 00 00 00 00 00 00 13 00 00 00 00 00 00 25 25 25 25 25 13 00 00 00 00 00 00 00 25 00 00 00 00 00 00 00 07 00 00 00 00 13 00 00 00 00 00 00 13 
13 00 00 13 00 00 00 00 00 00 00 00 00 00 00 00 00 00 00 00 00 00 00 13 00 00 00 00 00 00 00 00 00 00 00 13 00 00 00 00 00 00 00 00 00 00 00 00 00 00 00 13 00 00 00 00 13 00 00 00 00 00 00 13 
13 00 00 13 00 00 00 00 00 00 00 00 00 00 00 00 00 00 00 00 00 00 00 13 00 00 00 00 00 00 00 00 00 00 00 13 00 00 00 00 00 00 00 00 00 00 00 00 00 00 00 13 00 00 00 00 13 00 00 00 00 00 00 13 
13 00 00 17 00 00 00 00 00 00 00 00 00 00 00 00 00 00 00 00 00 00 00 13 00 00 00 00 00 00 00 00 00 00 00 13 00 00 00 00 00 00 00 07 00 00 00 00 00 00 00 13 00 00 00 00 13 00 00 00 00 00 00 13 
13 00 00 25 00 00 00 00 00 00 00 00 00 00 00 00 00 00 00 00 00 00 00 13 00 00 00 00 00 00 00 00 00 00 00 17 00 00 00 00 00 00 00 13 00 00 00 00 00 00 00 13 00 00 00 00 13 00 00 00 00 00 00 13 
13 00 00 00 00 00 00 00 00 07 00 00 00 00 07 00 00 00 00 00 00 00 00 13 00 00 00 00 00 00 00 00 00 00 00 25 00 00 16 09 09 09 09 10 09 09 09 09 09 09 09 05 00 00 00 16 19 00 00 00 00 00 00 13 
13 00 00 00 00 00 00 00 00 13 00 00 00 00 13 00 00 00 00 00 00 00 00 13 00 00 00 00 00 00 00 00 00 00 00 00 00 00 25 25 25 25 25 25 25 25 25 25 25 25 25 25 00 00 00 25 13 00 00 00 00 00 00 13 
13 00 00 07 00 00 00 00 00 13 00 00 00 00 13 00 00 00 00 00 00 00 00 13 00 00 00 00 00 00 00 00 00 00 00 00 00 00 00 00 00 00 00 00 00 00 00 00 00 00 00 00 00 00 00 00 13 00 00 00 00 00 00 13 
13 00 00 13 00 00 00 00 00 13 00 00 00 00 13 00 00 00 00 00 00 00 00 13 00 00 00 00 00 00 00 00 00 00 00 07 00 00 00 00 00 00 00 00 00 00 00 00 00 00 00 00 00 00 00 00 13 00 00 00 00 00 00 13 
04 09 09 10 09 09 09 09 09 10 09 09 09 09 10 09 09 09 09 09 09 09 09 10 09 09 09 09 09 09 09 09 09 09 09 10 09 09 09 09 09 09 09 09 09 09 09 09 09 09 09 09 09 09 09 09 10 09 09 09 09 09 09 05 
20 20 20 20 20 20 20 20 20 20 20 20 20 20 20 20 20 20 20 20 20 20 20 20 20 20 20 20 20 20 20 20 20 20 20 20 20 20 20 20 20 20 20 20 20 20 20 20 20 20 20 20 20 20 20 20 20 20 20 20 20 20 20 20 

27
stairs 03 16 02 02 1 r
stairs 60 17 39 35 1 r
stairs 03 18 08 25 3 r
stairs 60 19 51 31 3 r

powerup 26 17 40 40 9 assets/Graphics/powerups/powerup_beltright/animation.txt
powerup 12 30 40 40 10 assets/Graphics/powerups/powerup_beltleft/animation.txt
powerup 53 7 40 40 10013 assets/Graphics/powerups/powerup_speedup/animation.txt
powerup 16 19 40 40 10014 assets/Graphics/powerups/powerup_speeddown/animation.txt

objective 15 19.5 25 45 0 assets/Graphics/objects/png_object/object_animation.txt
objective 27 33.5 25 45 1 assets/Graphics/objects/png_object/object_animation.txt
objective 44 16.5 25 45 2 assets/Graphics/objects/png_object/object_animation.txt
objective 39 6.5 25 45 3 assets/Graphics/objects/png_object/object_animation.txt

object 6 11.1 80 75 assets/Graphics/objects/png_object/object_animation.txt double_vending_80x75
object 9 11.1 80 75 assets/Graphics/objects/png_object/object_animation.txt double_vending_80x75

object 12.37 19.8 100 116 assets/Graphics/objects/png_object/object_animation.txt cubicle6_100x116
object 57.63 7.8 100 116 assets/Graphics/objects/png_object/object_animation.txt cubicle2_100x116
object 23.5 4.57 359 203 assets/Graphics/objects/png_object/object_animation.txt cubicles_x_6_2_359x203
object 18.4 32 190 196 assets/Graphics/objects/png_object/object_animation.txt cubicles_x_4_2_180x180

object 9 18.5 40 40 assets/Graphics/objects/png_object/object_animation.txt clock_40x40
object 9 0.5 40 40 assets/Graphics/objects/png_object/object_animation.txt clock_40x40
object 36 0.5 40 40 assets/Graphics/objects/png_object/object_animation.txt clock_40x40
object 46 23.5 40 40 assets/Graphics/objects/png_object/object_animation.txt clock_40x40
object 59 0.5 40 40 assets/Graphics/objects/png_object/object_animation.txt clock_40x40
object 2 24.5 40 40 assets/Graphics/objects/png_object/object_animation.txt clock_40x40
object 23 0.5 40 40 assets/Graphics/objects/png_object/object_animation.txt clock_40x40

object 21.5 11.1 65 50 assets/Graphics/objects/png_object/object_animation.txt fishtank_65x50

object 56.93 31 35 55 assets/Graphics/objects/png_object/object_animation.txt machine_left_35x55
object 58.93 31 35 55 assets/Graphics/objects/png_object/object_animation.txt machine_left_35x55
object 60.93 31 35 55 assets/Graphics/objects/png_object/object_animation.txt machine_left_35x55

object 1 5.9 25 50 assets/Graphics/objects/png_object/object_animation.txt plant_25x50
object 4 5.9 25 50 assets/Graphics/objects/png_object/object_animation.txt plant_25x50





