2
64 38

06 09 09 09 09 15 09 09 09 09 09 09 09 09 09 09 15 09 09 09 09 09 09 09 09 09 09 09 09 09 09 15 09 09 09 09 09 09 09 09 09 09 09 09 09 09 09 09 09 09 15 09 09 09 09 09 15 09 09 09 09 09 09 08 
13 20 20 20 20 13 20 20 20 20 20 20 20 20 20 20 13 20 20 20 25 20 20 20 20 20 20 20 20 20 20 13 20 20 20 20 20 20 20 20 20 20 20 20 20 20 20 20 20 20 13 20 20 20 20 20 17 20 25 20 20 20 20 13 
13 00 00 00 00 13 00 00 00 00 00 00 00 00 00 00 13 00 00 00 00 00 00 29 30 00 00 00 00 00 00 13 00 00 00 00 00 00 00 00 00 00 00 00 00 00 00 00 00 00 13 00 00 00 00 00 20 00 00 00 00 00 00 13 
13 00 00 00 00 13 00 00 00 00 00 00 00 00 00 00 13 00 00 28 26 27 00 31 32 00 00 00 00 00 00 13 00 00 00 00 00 00 00 00 00 00 00 00 00 00 00 00 00 00 13 00 00 00 00 00 00 28 26 27 00 29 30 13 
13 00 00 00 00 13 00 00 00 00 00 00 00 00 00 00 13 00 00 00 00 00 00 33 00 00 00 00 00 00 00 13 00 00 00 00 07 00 00 00 00 00 00 00 00 00 00 07 00 00 13 00 00 00 00 00 00 00 00 00 00 31 32 13 
03 18 00 00 16 19 00 00 00 00 00 00 00 00 00 00 13 00 00 00 00 00 00 00 00 00 00 00 00 00 00 13 00 00 00 00 13 00 00 00 00 00 00 00 00 00 00 13 00 00 13 00 00 00 00 00 13 00 00 00 00 33 00 13 
13 20 00 00 20 13 00 00 00 00 00 00 00 00 00 00 13 00 00 00 00 00 00 00 00 00 00 00 00 00 00 13 00 00 00 00 13 00 00 00 00 00 00 00 00 00 00 13 00 00 13 00 00 00 00 00 13 00 00 00 00 00 00 13 
13 00 00 00 00 13 00 00 00 00 00 00 00 00 00 00 13 00 00 00 00 00 00 00 00 00 00 00 00 00 00 13 00 00 00 00 13 00 00 00 00 00 00 00 00 00 00 13 00 00 13 00 00 00 00 00 13 00 00 00 00 24 00 13 
13 00 00 00 00 13 00 00 00 00 00 00 00 00 00 00 13 00 00 00 00 00 00 00 00 00 00 00 00 00 00 13 00 00 00 00 13 00 00 00 00 00 00 00 00 00 00 13 00 00 17 00 00 00 00 00 13 00 00 00 00 22 00 13 
13 00 00 00 00 13 00 00 00 00 00 00 00 00 00 00 13 00 00 00 00 00 00 00 00 00 00 00 00 00 00 13 00 00 00 00 13 00 00 00 00 00 00 00 00 00 00 13 00 00 20 00 00 00 00 00 13 00 00 00 00 00 00 13 
13 00 00 00 00 04 09 09 09 09 09 09 09 18 00 00 17 00 00 00 16 09 09 09 09 09 09 09 09 09 09 05 00 00 00 00 13 00 00 00 00 00 00 00 00 00 00 13 00 00 00 00 00 00 00 00 13 00 00 00 00 00 00 13 
13 00 00 00 00 20 20 20 20 20 20 20 20 20 00 00 20 00 00 00 20 20 20 20 20 20 20 20 20 20 20 20 00 00 00 00 13 00 00 00 00 00 00 00 00 00 00 13 00 00 00 00 00 00 00 00 13 00 00 00 00 00 00 13 
13 00 00 00 00 00 00 00 00 00 00 00 00 00 00 00 00 00 00 00 00 00 00 00 00 00 00 00 00 00 00 00 00 00 00 00 13 09 09 09 09 18 00 00 16 09 09 09 09 09 09 13 00 00 00 00 13 00 00 00 00 00 00 13 
13 00 00 00 00 00 00 00 00 00 00 00 00 00 00 00 00 00 00 00 00 00 00 00 00 00 00 00 00 00 00 00 00 00 00 00 13 20 20 20 20 20 00 00 20 20 20 20 20 20 20 13 00 00 00 00 13 00 00 00 00 00 00 13 
13 00 00 00 00 00 00 00 00 00 00 00 00 00 00 00 00 00 00 00 00 00 00 00 00 00 00 00 00 00 00 00 00 00 00 00 13 00 00 00 00 00 00 00 00 00 00 00 00 00 00 13 00 00 00 00 04 18 00 00 00 16 09 19 
13 00 00 00 00 00 00 00 00 00 00 00 00 00 00 00 00 00 00 00 00 00 00 00 00 00 00 00 00 00 06 09 09 09 09 09 05 00 00 00 00 00 00 00 00 00 00 00 00 00 00 13 00 00 00 00 20 20 00 00 00 20 20 13 
13 00 23 00 00 00 00 00 00 00 00 00 00 00 00 00 00 00 00 00 00 00 00 00 00 00 00 00 00 00 13 20 20 20 20 20 20 00 00 00 00 00 00 00 00 00 00 00 00 00 00 13 00 00 00 00 00 00 00 00 00 00 00 13 
13 00 21 00 00 00 00 00 00 00 00 00 00 00 00 00 00 00 00 00 00 00 00 00 00 00 00 00 00 00 13 00 00 00 00 00 00 00 00 00 00 00 00 00 00 00 00 00 00 00 00 13 00 00 00 00 00 00 00 00 00 00 00 13 
13 00 00 00 00 00 00 06 09 09 09 09 09 09 08 00 00 00 00 00 00 00 00 00 00 00 00 00 00 00 13 00 00 00 00 00 00 00 00 00 00 00 00 00 00 00 00 00 00 00 00 13 00 00 00 00 00 00 00 00 00 00 00 13 
13 00 00 00 00 00 00 13 20 20 20 20 25 20 13 00 00 00 00 00 00 00 00 00 00 00 00 00 00 00 13 00 00 00 00 00 16 09 09 15 09 18 00 00 00 00 00 00 00 00 00 13 00 00 00 00 00 00 00 00 00 00 00 13 
13 00 00 00 00 00 00 13 00 00 00 00 29 30 13 00 00 00 00 00 00 00 00 00 00 00 00 00 00 00 20 00 00 00 00 00 20 20 20 13 20 20 00 00 00 00 00 00 00 00 00 00 00 00 00 00 00 00 00 00 00 00 00 13 
13 00 00 00 00 00 00 13 00 00 00 00 31 32 13 00 00 00 00 00 00 00 00 00 00 00 00 00 00 00 00 00 00 00 00 00 00 00 00 13 00 00 00 00 00 00 00 00 00 00 00 00 00 00 00 00 00 00 00 00 00 00 00 13 
13 00 00 00 00 00 00 13 00 00 00 00 33 00 13 00 00 00 00 00 00 00 00 00 00 00 00 00 00 00 00 00 00 00 00 00 00 00 00 13 00 00 00 00 00 00 00 00 00 00 00 07 00 00 00 00 00 00 00 00 00 00 00 13 
13 00 00 00 00 00 00 13 00 28 00 00 28 00 13 00 00 00 00 00 00 00 00 00 00 00 00 00 00 00 07 00 00 00 00 00 16 09 09 09 09 09 09 15 09 09 09 09 09 09 09 05 00 00 00 00 06 09 18 00 00 16 09 19 
03 09 09 08 00 00 00 04 09 18 00 00 16 09 05 00 00 00 00 00 00 00 00 00 00 00 00 00 00 00 13 00 00 00 00 00 20 20 20 20 20 20 20 13 20 20 20 20 20 20 20 20 00 00 00 00 13 20 20 00 00 20 20 13 
13 20 20 13 00 00 00 20 20 20 00 00 20 20 20 00 00 00 00 00 00 00 00 00 00 00 00 00 00 00 13 00 00 00 00 00 00 00 00 29 30 00 00 13 26 27 28 00 00 00 00 00 00 00 00 00 13 00 00 00 00 00 00 13 
13 00 00 13 00 00 00 00 00 00 00 00 00 00 00 00 00 00 00 00 00 00 00 07 00 00 00 00 00 00 04 09 09 09 09 08 00 00 00 31 32 00 00 17 00 00 00 00 00 00 00 00 00 00 00 00 13 00 28 00 00 28 00 13 
13 00 00 13 00 00 00 00 00 00 00 00 00 00 00 00 00 00 00 00 00 00 00 13 00 00 00 00 00 00 20 20 20 20 20 13 00 00 00 33 00 00 00 20 00 00 00 00 00 00 00 07 00 00 00 00 13 29 30 00 00 00 00 13 
13 00 00 13 00 00 00 00 00 00 00 00 00 00 00 00 00 00 00 00 00 00 00 13 00 00 00 00 00 00 00 00 00 00 00 13 00 00 00 00 00 00 00 00 00 00 00 00 00 29 30 13 00 00 00 00 13 31 32 00 00 00 00 13 
13 00 00 13 00 00 00 00 00 00 00 00 00 00 00 00 00 00 00 00 00 00 00 13 00 00 00 00 00 00 00 00 00 00 00 13 00 00 00 00 00 00 00 00 00 00 00 00 00 31 32 13 00 00 00 00 13 33 00 00 00 00 00 13 
13 00 00 17 00 00 00 00 00 00 00 00 00 00 00 00 00 00 00 00 00 00 00 13 00 00 00 00 00 00 00 00 00 00 00 13 00 00 00 00 00 00 00 07 00 00 00 00 00 33 00 13 00 00 00 00 13 00 00 00 00 00 00 13 
13 00 00 20 00 00 00 00 00 00 00 00 00 00 00 00 00 00 00 00 00 00 00 13 00 00 00 00 00 00 00 00 00 00 00 17 00 00 00 00 00 00 00 13 00 00 00 00 00 00 00 13 00 00 00 00 13 00 00 00 00 00 00 13 
13 00 00 00 00 00 00 00 00 07 00 00 00 00 07 00 00 00 00 00 00 00 00 13 00 00 00 00 00 00 00 00 00 00 00 20 00 00 16 09 09 09 09 09 09 09 09 09 09 09 09 05 00 00 00 16 19 00 00 00 00 00 00 13 
13 00 00 00 00 00 00 00 00 13 00 00 00 00 13 00 00 00 00 00 00 00 00 13 00 00 00 00 00 00 00 00 00 00 00 00 00 00 20 20 20 20 20 20 20 20 20 20 20 20 20 20 00 00 00 20 13 00 00 00 00 00 00 13 
13 00 00 07 00 00 00 00 00 13 00 00 00 00 13 00 00 00 00 00 00 00 00 13 00 00 00 00 00 00 00 00 00 00 00 00 00 00 00 00 00 00 00 00 00 00 00 00 00 00 00 00 00 00 00 00 13 00 00 00 00 00 00 13 
13 00 00 13 00 00 00 00 00 13 00 00 00 00 13 00 00 00 00 00 00 00 00 13 00 00 00 00 00 00 00 00 00 00 00 07 00 00 00 00 00 00 00 00 00 00 00 00 00 00 00 00 00 00 00 00 13 00 00 00 00 00 00 13 
04 09 09 10 09 09 09 09 09 10 09 09 09 09 10 09 09 09 09 09 09 09 09 10 09 09 09 09 09 09 09 09 09 09 09 10 09 09 09 09 09 09 09 09 09 09 09 09 09 09 09 09 09 09 09 09 10 09 09 09 09 09 09 05 
20 20 20 20 20 20 20 20 20 20 20 20 20 20 20 20 20 20 20 20 20 20 20 20 20 20 20 20 20 20 20 20 20 20 20 20 20 20 20 20 20 20 20 20 20 20 20 20 20 20 20 20 20 20 20 20 20 20 20 20 20 20 20 20 

4
stairs 02 17 04 02 1
stairs 61 08 35 38 1
stairs 02 18 04 03 3
stairs 61 07 01 02 3

