2
64 38

06 09 09 09 09 15 09 09 09 09 09 09 09 09 09 09 15 09 09 09 09 09 09 09 09 09 09 09 09 09 09 15 09 09 09 09 09 09 09 09 09 09 09 09 09 09 09 09 09 09 15 09 09 09 09 09 15 09 09 09 09 09 09 08 
13 25 25 25 25 13 25 25 25 35 35 35 35 35 25 25 13 25 25 25 26 25 25 25 25 25 25 35 35 35 35 13 25 25 25 25 25 25 25 25 25 25 25 25 25 25 25 25 25 25 13 25 25 25 25 25 17 25 26 25 35 25 25 13 
13 00 00 00 00 13 29 30 31 36 36 36 36 36 30 31 13 00 00 00 00 00 00 30 31 30 31 36 36 36 36 13 29 00 00 00 00 00 00 00 00 00 00 00 00 00 00 00 00 00 13 29 00 00 00 00 25 29 27 28 36 00 00 13 
13 00 00 00 00 13 00 32 33 00 00 00 00 00 32 33 13 00 00 29 27 28 00 32 33 32 33 00 00 00 00 13 00 00 00 00 00 00 00 00 00 00 00 00 00 00 00 00 00 00 13 00 00 00 00 00 00 00 00 00 00 00 00 13 
13 00 00 00 00 13 00 34 00 00 00 00 00 00 34 00 13 00 00 00 00 00 00 34 00 34 00 00 00 00 00 13 00 00 00 00 07 00 00 00 00 00 00 00 00 00 00 07 00 00 13 00 00 00 00 00 00 00 00 00 00 30 31 13 
03 18 00 00 16 19 00 00 00 00 00 00 00 00 00 00 13 00 00 00 00 00 00 00 00 00 00 00 00 00 00 13 00 00 00 00 13 00 00 00 00 00 00 00 00 00 00 13 00 00 13 00 00 00 00 00 07 00 00 00 00 32 33 13 
13 25 00 00 25 13 00 00 00 00 00 00 00 00 00 00 13 00 00 00 00 00 00 00 00 00 00 00 00 00 00 13 00 00 00 00 13 00 00 00 00 00 00 00 00 00 00 13 00 00 13 00 00 00 00 00 13 00 00 00 00 34 00 13 
13 29 00 00 29 13 00 00 37 38 00 00 37 38 00 00 13 00 00 00 00 37 38 00 37 38 00 37 38 00 00 13 00 00 00 00 13 00 00 00 00 00 00 00 00 00 00 13 00 00 13 00 00 00 00 00 13 37 38 00 00 00 00 13 
13 29 00 00 29 13 00 00 00 00 00 00 00 00 00 00 13 00 00 00 00 00 00 00 00 00 00 00 00 00 00 13 00 00 00 00 13 00 00 00 00 00 00 00 00 00 00 13 00 00 17 00 00 00 00 00 13 30 31 00 00 00 00 13 
13 00 00 00 00 13 00 00 00 00 00 00 00 00 00 00 13 00 00 00 00 00 00 00 00 00 00 00 00 00 00 13 00 00 00 00 13 00 00 00 00 00 00 00 00 00 00 13 00 00 25 29 00 00 00 00 13 32 33 00 00 00 00 13 
13 00 00 00 00 04 09 09 09 09 09 09 09 18 00 00 17 00 00 00 16 09 09 09 09 09 09 09 09 09 09 05 00 00 00 00 13 00 00 00 00 00 00 00 00 00 00 13 00 00 00 00 00 00 00 00 13 34 00 00 00 30 31 13 
13 00 00 00 00 25 25 25 25 25 25 25 25 25 00 00 25 00 00 00 25 25 25 25 25 25 25 25 25 25 25 25 00 00 00 00 13 00 00 00 00 00 00 00 00 00 00 13 00 00 00 00 00 00 00 00 13 00 00 00 00 32 33 13 
13 00 00 00 00 00 00 00 00 00 00 00 00 00 00 00 00 00 00 00 00 00 00 00 00 00 00 00 00 00 00 00 00 00 00 00 03 09 09 09 09 18 00 00 16 09 09 10 09 09 09 08 00 00 00 00 13 00 00 00 00 34 00 13 
13 00 00 00 00 00 00 00 00 00 00 00 00 00 00 00 00 00 00 00 00 00 00 00 00 00 00 00 00 00 00 00 00 00 00 00 13 25 25 25 25 25 00 00 25 25 25 25 25 25 25 13 00 00 00 00 13 00 00 00 00 00 00 13 
13 00 00 00 00 00 00 00 00 00 00 00 00 00 00 00 00 00 00 00 00 00 00 00 00 00 00 00 00 00 00 00 00 00 00 29 13 00 00 00 00 00 00 00 00 00 00 00 00 00 29 13 00 00 00 00 04 18 00 00 00 16 09 19 
13 00 00 00 00 00 00 00 00 00 00 00 00 00 00 00 00 00 00 00 00 00 00 00 00 00 00 00 00 00 06 09 09 09 09 09 05 00 00 00 00 00 00 00 00 00 00 00 00 00 00 13 00 00 00 29 25 25 00 00 00 25 25 13 
13 00 00 22 00 00 00 00 00 00 00 00 00 00 00 00 00 00 00 00 00 00 00 00 00 00 00 00 00 00 13 25 25 25 25 25 25 00 00 00 00 00 00 00 00 00 00 00 00 00 00 13 00 00 00 00 00 00 00 00 00 00 00 13 
13 00 00 00 00 00 00 00 00 00 00 00 00 00 00 00 00 00 00 00 00 00 00 00 00 00 00 00 00 00 13 29 29 00 00 00 00 00 00 00 00 00 00 00 00 00 00 00 00 00 00 13 00 00 00 00 00 00 00 00 22 00 00 13 
13 00 00 24 00 00 00 06 09 09 09 09 09 09 08 00 00 00 00 00 00 00 00 00 00 00 00 00 00 00 13 00 00 00 00 00 00 00 00 00 00 00 00 00 00 00 00 00 00 00 00 13 00 00 00 00 00 00 00 00 00 00 00 13 
13 00 00 00 00 00 00 13 25 25 25 35 26 25 13 00 00 00 00 00 00 00 00 00 00 00 00 00 00 00 17 00 00 00 00 00 16 09 09 15 09 18 00 00 00 00 00 00 00 00 00 13 29 00 00 00 00 00 00 00 24 00 00 13 
13 00 00 00 00 00 00 13 37 38 00 36 30 31 13 00 00 00 00 00 00 00 00 00 00 00 00 00 00 00 25 00 00 00 00 00 25 25 25 13 25 25 00 00 00 00 00 00 00 00 00 00 00 00 00 00 00 00 00 00 00 00 00 13 
13 00 00 00 00 00 00 13 00 00 00 00 32 33 13 00 00 00 00 00 00 00 00 00 00 00 00 00 00 00 00 00 00 00 00 00 00 00 00 13 00 00 00 00 00 00 00 00 00 00 00 00 00 00 00 00 00 00 00 00 00 00 00 13 
13 00 00 00 00 00 00 13 00 00 00 00 34 00 13 00 00 00 00 00 00 00 00 00 00 00 00 00 00 00 00 00 00 00 00 00 00 00 00 13 00 00 00 00 00 00 00 00 00 00 00 07 29 00 00 00 00 00 00 00 00 00 00 13 
13 00 00 00 00 00 00 13 00 29 00 00 29 00 13 00 00 00 00 00 00 00 00 00 00 00 00 00 00 00 07 00 00 00 00 00 16 09 09 10 09 09 09 15 09 09 09 09 09 09 09 05 00 00 00 29 06 09 18 00 00 16 09 19 
03 09 09 08 00 00 00 04 09 18 00 00 16 09 05 00 00 00 00 00 00 00 00 00 00 00 00 00 00 00 13 00 00 00 00 00 25 25 25 25 25 35 35 13 25 25 25 35 25 25 25 25 00 00 00 00 13 35 25 00 00 25 35 13 
13 25 25 13 00 00 00 25 25 25 00 00 25 25 25 00 00 00 00 00 00 00 00 00 00 00 00 00 00 00 13 00 00 00 00 00 00 00 00 30 31 36 36 13 27 28 29 36 00 00 00 00 00 00 00 00 13 36 00 00 00 00 36 13 
13 29 00 13 00 00 00 00 00 00 00 00 00 00 00 00 00 00 00 00 00 00 00 07 00 00 00 00 00 00 04 09 09 09 09 08 00 00 00 32 33 00 00 17 00 00 00 00 00 00 00 00 00 00 00 00 13 00 29 00 00 29 00 13 
13 00 00 13 00 00 00 00 00 00 00 00 00 00 00 00 00 00 00 00 00 00 00 13 00 00 00 00 00 00 25 25 25 25 25 13 00 00 00 34 00 00 00 25 00 00 00 00 00 00 00 07 00 00 00 00 13 00 00 00 00 00 00 13 
13 00 00 13 00 00 00 00 00 00 00 00 00 00 00 00 00 00 00 00 00 00 00 13 00 00 00 00 00 00 00 00 00 29 29 13 00 00 00 00 00 00 00 00 00 00 00 00 00 30 31 13 00 00 00 00 13 00 00 00 00 00 00 13 
13 00 00 13 00 00 00 00 00 00 00 00 00 00 00 00 00 00 00 00 00 00 00 13 00 00 00 00 00 00 00 00 00 00 29 13 00 00 00 00 00 00 00 00 00 00 00 00 00 32 33 13 00 00 00 00 13 00 00 00 00 00 00 13 
13 00 00 17 00 00 00 00 00 00 00 00 00 00 00 00 00 00 00 00 00 00 00 13 00 00 00 00 00 00 00 00 00 00 00 13 00 00 00 00 00 00 00 07 00 00 00 00 00 34 00 13 00 00 00 00 13 00 00 00 00 00 00 13 
13 00 00 25 00 00 00 00 00 00 00 00 00 00 00 00 00 00 00 00 00 00 00 13 00 00 00 00 00 00 00 00 00 00 00 17 00 00 00 00 00 00 29 13 29 00 00 00 00 00 00 13 00 00 00 00 13 00 00 37 38 00 00 13 
13 00 00 00 00 00 00 00 00 07 00 00 00 00 07 00 00 00 00 00 00 00 00 13 00 00 00 00 00 00 00 00 00 00 00 25 00 00 16 09 09 09 09 10 09 09 09 09 09 09 09 05 00 00 00 16 19 00 00 00 00 00 00 13 
13 00 00 00 00 00 00 00 00 13 00 00 00 00 13 00 00 00 00 00 00 00 00 13 00 00 00 00 00 00 00 00 00 00 00 00 00 00 25 25 25 25 25 25 25 25 25 25 25 25 25 25 00 00 00 25 13 00 00 30 31 00 00 13 
13 00 00 07 00 00 00 00 00 13 00 00 00 00 13 00 00 00 00 00 00 00 00 13 00 00 00 00 00 00 00 00 00 00 00 00 00 00 00 00 00 00 00 00 00 00 00 00 00 00 00 00 00 00 00 00 13 00 00 32 33 00 00 13 
13 29 00 13 29 00 00 00 29 13 29 00 00 29 13 29 00 00 00 00 00 00 29 13 29 00 00 00 00 00 00 00 00 00 00 07 00 00 00 00 00 00 00 00 00 00 00 00 00 00 00 00 00 00 00 00 13 29 00 34 00 00 29 13 
04 09 09 10 09 09 09 09 09 10 09 09 09 09 10 09 09 09 09 09 09 09 09 10 09 09 09 09 09 09 09 09 09 09 09 10 09 09 09 09 09 09 09 09 09 09 09 09 09 09 09 09 09 09 09 09 10 09 09 09 09 09 09 05 
20 20 20 20 20 20 20 20 20 20 20 20 20 20 20 20 20 20 20 20 20 20 20 20 20 20 20 20 20 20 20 20 20 20 20 20 20 20 20 20 20 20 20 20 20 20 20 20 20 20 20 20 20 20 20 20 20 20 20 20 20 20 20 20 

8
stairs 03 16 02 02 1 r
stairs 60 17 39 35 1 r
stairs 03 18 08 25 3 r
stairs 60 19 51 31 3 r

objective 15 20 25 45 0 assets/Graphics/objects/png_object/object_animation.txt
objective 27 34 25 45 1 assets/Graphics/objects/png_object/object_animation.txt
objective 44 17 25 45 2 assets/Graphics/objects/png_object/object_animation.txt
objective 39 06 25 45 3 assets/Graphics/objects/png_object/object_animation.txt
