9
31 18

06 09 09 09 09 09 09 09 09 09 09 09 09 09 09 09 09 09 09 09 09 09 09 09 09 09 09 09 09 09 08 
13 25 25 25 25 25 25 25 25 25 25 25 25 25 25 25 25 25 25 25 25 25 25 25 25 25 25 25 25 25 13 
13 00 00 00 00 00 00 00 00 00 00 00 00 00 00 00 00 00 00 00 00 00 00 00 00 00 00 00 00 00 13 
13 00 00 00 00 00 00 00 00 00 00 00 00 00 00 00 00 00 00 00 00 00 00 00 00 00 00 00 24 00 13 
13 00 00 00 00 06 08 00 00 00 00 00 06 08 00 00 00 00 00 06 08 00 00 00 00 00 00 00 00 00 13 
13 00 00 00 00 04 05 00 00 00 00 00 04 05 00 00 00 00 00 04 05 00 00 00 00 00 00 00 00 00 13 
13 00 00 00 00 25 25 00 00 00 00 00 25 25 00 00 00 00 00 25 25 00 00 00 00 00 00 00 00 00 13 
13 00 00 00 00 00 00 00 00 00 00 00 00 00 00 00 00 00 00 00 00 00 00 00 00 00 00 00 00 00 13 
13 00 00 00 00 00 00 00 00 00 00 00 00 00 00 00 00 00 00 00 00 00 00 00 00 00 00 00 00 00 13 
13 00 00 00 00 00 00 00 00 00 00 00 00 00 00 00 00 00 00 00 00 00 00 00 00 00 00 00 00 00 13 
13 00 00 00 00 06 08 00 00 00 00 00 06 08 00 00 00 00 00 06 08 00 00 00 00 00 06 08 00 00 13 
13 00 00 00 00 04 05 00 00 00 00 00 04 05 00 00 00 00 00 04 05 00 00 00 00 00 04 05 00 00 13 
13 00 00 00 00 25 25 00 00 00 00 00 25 25 00 00 00 00 00 25 25 00 00 00 00 00 25 25 00 00 13 
13 00 00 00 00 00 00 00 00 00 00 00 00 00 00 00 00 00 00 00 00 00 00 00 00 00 00 00 00 00 13 
13 00 00 00 00 00 00 00 00 00 00 00 00 00 00 00 00 00 00 00 00 00 00 00 00 00 00 00 00 00 13 
13 00 00 00 00 00 00 00 00 00 00 00 00 00 00 00 00 00 00 00 00 00 00 00 00 00 00 00 23 00 13 
04 09 09 09 09 09 09 09 09 09 09 09 09 09 09 09 09 09 09 09 09 09 09 09 09 09 09 09 09 09 05 
20 20 20 20 20 20 20 20 20 20 20 20 20 20 20 20 20 20 20 20 20 20 20 20 20 20 20 20 20 20 20 

14
stairs 28 15 61	32 1 l
stairs 28 03 57 32 1 r

object 2 3.5 120 160 assets/Graphics/objects/png_object/object_animation.txt empty_parkinglot_120x160

object 9 3.5 120 160 assets/Graphics/objects/png_object/object_animation.txt empty_parkinglot_120x160

object 16 3.5 120 160 assets/Graphics/objects/png_object/object_animation.txt empty_parkinglot_120x160

object 23 3.5 160 160 assets/Graphics/objects/png_object/object_animation.txt empty_parkinglot_160x160

object 2 13.5 120 160 assets/Graphics/objects/png_object/object_animation.txt empty_parkinglot_120x160

object 9 13.5 120 160 assets/Graphics/objects/png_object/object_animation.txt empty_parkinglot_120x160

object 16 13.5 120 160 assets/Graphics/objects/png_object/object_animation.txt empty_parkinglot_120x160

object 23 13.5 160 160 assets/Graphics/objects/png_object/object_animation.txt empty_parkinglot_160x160

object 7 8 200 130 assets/Graphics/objects/png_object/object_animation.txt car_robber_200x130

object 2 3.5 100 140 assets/Graphics/objects/png_object/object_animation.txt car1_100x140

object 16 13.5 100 120 assets/Graphics/objects/png_object/object_animation.txt car2_100x120

object 23 13.5 100 140 assets/Graphics/objects/png_object/object_animation.txt car3_100x140
