0 
31 16

02 02 02 02 02 02 02 02 02 02 06 09 09 09 09 09 09 09 09 09 08 02 02 02 02 02 02 02 02 02 02 
02 02 02 02 02 02 02 02 02 02 13 20 20 20 20 20 20 20 20 20 13 02 02 02 02 02 02 02 02 02 02 
02 02 02 02 02 02 02 02 02 02 13 21 24 24 24 24 24 24 24 24 13 02 02 02 02 02 02 02 02 02 02 
06 09 09 09 09 09 14 09 09 09 05 22 25 25 25 25 25 25 25 25 04 09 09 09 14 09 09 09 09 09 08 
13 20 20 20 20 20 13 20 20 20 20 23 26 26 26 26 26 26 26 26 20 20 20 20 13 20 20 20 20 20 13 
13 02 02 02 02 02 13 02 02 02 02 27 27 27 27 27 27 27 27 27 02 02 02 02 13 02 02 02 02 02 13 
13 02 02 02 02 02 13 02 02 02 02 02 02 02 02 02 02 02 02 02 02 02 02 02 13 02 02 02 02 02 13 
13 02 49 50 51 02 17 02 02 02 02 02 02 02 02 02 02 02 02 02 02 02 02 02 17 02 64 65 66 02 13 
13 02 52 53 54 02 20 02 02 02 02 02 02 02 02 02 02 02 02 02 02 02 02 02 20 02 67 68 69 02 13 
13 02 55 56 57 02 02 02 02 02 02 02 02 02 02 02 02 02 02 02 02 02 02 02 02 02 70 71 72 02 13 
13 02 58 59 60 02 02 02 02 02 02 02 02 02 02 02 02 02 02 02 02 02 02 02 02 02 73 74 75 02 13 
13 02 61 62 63 02 07 02 02 02 02 02 02 02 02 02 02 02 02 02 02 02 02 02 07 02 76 77 78 02 13 
13 02 02 02 02 02 13 02 02 02 02 02 02 02 02 02 02 02 02 02 02 02 02 02 13 02 02 02 02 02 13 
13 02 02 02 02 02 13 02 02 02 02 02 02 02 02 02 02 02 02 02 02 02 02 02 13 02 02 02 02 02 13 
04 09 09 09 09 09 10 09 09 09 09 09 09 09 09 09 09 09 09 09 09 09 09 09 10 09 09 09 09 09 05 
20 20 20 20 20 20 20 20 20 20 20 20 20 20 20 20 20 20 20 20 20 20 20 20 20 20 20 20 20 20 20 

