0 
31 16

02 02 02 02 02 02 02 02 02 02 06 09 09 09 09 09 09 09 09 09 08 02 02 02 02 02 02 02 02 02 02 
02 02 02 02 02 02 02 02 02 02 13 20 20 20 20 20 20 20 20 20 13 02 02 02 02 02 02 02 02 02 02 
02 02 02 02 02 02 02 02 02 02 13 21 24 24 24 24 24 24 24 24 13 02 02 02 02 02 02 02 02 02 02 
06 09 09 09 09 09 14 09 09 09 05 22 25 25 25 25 25 25 25 25 04 09 09 09 14 09 09 09 09 09 08 
13 20 20 20 20 20 13 20 20 20 20 23 26 26 26 26 26 26 26 26 20 20 20 20 13 20 20 20 20 20 13 
13 00 00 28 00 00 13 00 00 00 00 27 27 27 27 27 27 27 27 27 00 00 00 00 13 00 00 00 00 00 13 
13 00 00 00 00 00 13 00 00 00 00 00 00 00 00 00 00 00 00 00 00 00 00 00 13 00 00 00 00 00 13 
13 00 00 00 00 00 17 00 00 00 00 00 00 00 00 00 00 00 00 00 00 00 00 00 17 00 00 00 00 00 13 
13 00 00 00 00 00 20 00 00 00 00 00 00 00 00 00 00 00 00 00 00 00 00 00 20 00 00 00 00 00 13 
13 00 00 00 00 00 00 00 00 00 00 00 00 00 00 00 00 00 00 00 00 00 00 00 00 00 00 00 00 00 13 
13 00 00 00 00 00 00 00 00 00 00 00 00 00 00 00 00 00 00 00 00 00 00 00 00 00 00 00 00 00 13 
13 00 00 00 00 00 07 00 00 00 00 00 00 00 00 00 00 00 00 00 00 00 00 00 07 00 00 00 00 00 13 
13 00 00 00 00 00 13 00 00 00 00 00 00 00 00 00 00 00 00 00 00 00 00 00 13 00 00 00 00 00 13 
13 00 00 00 00 00 13 00 00 00 00 00 00 00 00 00 00 00 00 00 00 00 00 00 13 00 00 00 00 00 13 
04 09 09 09 09 09 10 09 09 09 09 09 09 09 09 09 09 09 09 09 09 09 09 09 10 09 09 09 09 09 05 
20 20 20 20 20 20 20 20 20 20 20 20 20 20 20 20 20 20 20 20 20 20 20 20 20 20 20 20 20 20 20 

2
sound 1
stair 3 5 1.5 2 1 l
